"구군","제공연도","동수","세대수","총인구수","남성인구수","여성인구수","시 전체 인구비율","인구밀도"
"부산광역시 해운대구","Oct-22","18","170828","392763","188511","204252","11.7","7621"
"부산광역시 해운대구","Nov-22","18","170637","392291","188227","204064","11.6","7611"
"부산광역시 해운대구","Dec-22","18","170435","391763","187958","203805","11.6","7601"
"부산광역시 해운대구","Jan-23","18","170261","391279","187735","203544","11.6","7592"
"부산광역시 해운대구","Jun-22","18","171960","396120","190250","205870","11.7","7686"
"부산광역시 해운대구","Jul-22","18","172005","395601","189985","205616","11.7","7676"
"부산광역시 해운대구","Aug-22","18","171837","394626","189458","205168","11.7","7657"
"부산광역시 해운대구","Sep-22","18","170998","393151","188716","204435","11.7","7628"
"부산광역시 해운대구","Feb-22","18","172279","399486","191987","207499","11.8","7751"
"부산광역시 해운대구","Mar-22","18","172227","398483","191470","207013","11.8","7732"
"부산광역시 해운대구","Apr-22","18","172217","397957","191257","206700","11.8","7721"
"부산광역시 해운대구","May-22","18","172126","396931","190686","206245","11.7","7701"
"부산광역시 해운대구","Sep-21","18","172237","402554","193562","208992","11.8","7817"
"부산광역시 해운대구","Oct-21","18","172349","402195","193432","208763","11.8","7810"
"부산광역시 해운대구","Nov-21","18","172455","401778","193218","208560","11.8","7802"
"부산광역시 해운대구","Dec-21","18","172397","401131","192901","208230","11.8","7783"
"부산광역시 해운대구","Jan-22","18","172327","400488","192518","207970","11.8","7770"
"부산광역시 해운대구","May-21","18","171558","403908","194388","209520","11.8","7843"
"부산광역시 해운대구","Jun-21","18","171791","403635","194245","209390","11.8","7838"
"부산광역시 해운대구","Jul-21","18","171911","403262","194033","209229","11.8","7830"
"부산광역시 해운대구","Aug-21","18","172076","402709","193728","208981","11.8","7820"
"부산광역시 해운대구","Jan-21","18","171528","406349","195600","210749","11.8","7890"
"부산광역시 해운대구","Feb-21","18","171770","405922","195335","210587","11.8","7882"
"부산광역시 해운대구","Mar-21","18","171352","404748","194836","209912","11.8","7859"
"부산광역시 해운대구","Apr-21","18","171558","404514","194679","209835","11.8","7855"
"부산광역시 해운대구","Sep-20","18","170518","407443","196191","211252","11.8","7916"
"부산광역시 해운대구","Oct-20","18","170815","407492","196181","211311","11.8","7917"
"부산광역시 해운대구","Nov-20","18","171099","407182","196040","211142","11.8","7911"
"부산광역시 해운대구","Dec-20","18","171376","406818","195883","210935","11.8","7899"
"부산광역시 해운대구","Feb-23","18","170331","390489","187324","203165","11.6","7576"
"부산광역시 해운대구","Mar-23","18","170251","389843","186999","202844","11.6","7564"
"부산광역시 해운대구","Apr-23","18","170185","389361","186762","202599","11.6","7555"
"부산광역시 해운대구","May-23","18","170221","389117","186620","202497","11.6","7550"
"부산광역시 해운대구","Mar-20","18","169141","410223","197881","212342","11.9","7970"
"부산광역시 해운대구","Apr-20","18","169357","410242","197838","212404","11.9","7971"
"부산광역시 해운대구","May-20","18","169532","409307","197310","211997","11.8","7952"
"부산광역시 해운대구","Jun-20","18","169825","408732","196993","211739","11.8","7941"
"부산광역시 해운대구","Jul-20","18","170255","408611","196894","211717","11.8","7939"
"부산광역시 해운대구","Aug-20","18","170290","407804","196437","211367","11.8","7923"
"부산광역시 해운대구","Oct-19","18","168247","411176","198486","212690","11.8","7989"
"부산광역시 해운대구","Nov-19","18","168454","411346","198530","212816","11.9","7992"
"부산광역시 해운대구","Dec-19","18","168650","411293","198499","212794","11.9","7991"
"부산광역시 해운대구","Jan-20","18","168851","411497","198570","212927","11.9","7995"
"부산광역시 해운대구","Feb-20","18","168916","410898","198269","212629","11.9","7983"
"부산광역시 해운대구","Apr-19","18","167666","413611","199741","213870","11.9","8036"
"부산광역시 해운대구","May-19","18","167782","413160","199482","213678","11.9","8027"
"부산광역시 해운대구","Jun-19","18","167790","412658","199239","213419","11.9","8017"
"부산광역시 해운대구","Jul-19","18","167827","412170","199000","213170","11.9","8008"
"부산광역시 해운대구","Aug-19","18","167937","411693","198746","212947","11.8","7999"
"부산광역시 해운대구","Sep-19","18","168095","411445","198642","212803","11.8","7994"
"부산광역시 해운대구","2018","18","166156","415530","201072","214458","11.9","8073"
"부산광역시 해운대구","2018","18","166357","415413","200994","214419","11.9","8071"
"부산광역시 해운대구","Jan-19","18","166906","414415","200323","214092","11.9","8052"
"부산광역시 해운대구","Feb-19","18","167223","414258","200209","214049","11.9","8049"
"부산광역시 해운대구","Mar-19","18","167490","413911","199992","213919","11.9","8042"
"부산광역시 해운대구","2018","18","166545","414834","200643","214191","11.9","8060"
"부산광역시 해운대구","2018","18","166748","414611","200474","214137","11.9","8055"
"부산광역시 해운대구","2018","18","165529","417174","202167","215007","11.9","8105"
"부산광역시 해운대구","2018","18","165796","417100","202104","214996","11.9","8104"
"부산광역시 해운대구","2018","18","165857","416930","201965","214965","11.9","8100"
"부산광역시 해운대구","2018","18","166035","415896","201333","214563","11.9","8080"
"부산광역시 해운대구","2017","18","165002","417161","202206","214955","11.9","8105"
"부산광역시 해운대구","2018","18","165184","416956","202085","214871","11.9","8101"
"부산광역시 해운대구","2018","18","165959","416668","201772","214896","11.9","8095"
"부산광역시 해운대구","2018","18","165966","416311","201582","214729","11.9","8088"
"부산광역시 해운대구","2018","18","166534","415127","200795","214332","11.9","8065"
"부산광역시 해운대구","2017","18","165291","422005","204775","217230","11.9","8199"
"부산광역시 해운대구","2017","18","165325","421409","204439","216970","11.9","8187"
"부산광역시 해운대구","2017","18","165331","420825","204161","216664","11.9","8176"
"부산광역시 해운대구","2017","18","165227","419243","203289","215954","11.9","8145"
"부산광역시 해운대구","2017","18","165111","418275","202764","215511","11.9","8126"
"부산광역시 해운대구","2017","18","165076","417779","202533","215246","11.9","8117"
"부산광역시 해운대구","2017","18","165279","419984","203699","216285","11.9","8160"
"부산광역시 해운대구","2017","18","165314","424532","206120","218412","12","8248"
"부산광역시 해운대구","2017","18","165334","423609","205667","217942","12","8230"
"부산광역시 해운대구","2017","18","165300","423107","205345","217762","11.9","8220"
"부산광역시 해운대구","2017","18","165314","422674","205131","217543","11.9","8212"
"부산광역시 해운대구","2013","18","161081","429109","209230","219879","12.04","8337"
"부산광역시 해운대구","2014","18","162347","427460","208414","219046","12.02","8305"
"부산광역시 해운대구","2015","17","164386","428004","208501","219503","12","8316"
"부산광역시 해운대구","2016","18","165290","425036","206459","218577","12","8258"
"부산광역시 해운대구","2017","18","165002","417161","202206","214955","11.9","8105"
"부산광역시 해운대구","2007","18","148828","426138","209496","216642","11.79","8283"
"부산광역시 해운대구","2008","18","150668","426949","209488","217461","11.87","8297"
"부산광역시 해운대구","2009","18","153019","427619","209595","218024","11.96","8310"
"부산광역시 해운대구","2010","18","157282","429477","210163","219314","11.93","8346"
"부산광역시 해운대구","2011","18","158114","428663","209690","218973","11.95","8330"
"부산광역시 해운대구","2012","18","160053","431526","210759","220767","12.08","8386"
"부산광역시 중구","Oct-22","9","24056","42136","20846","21290","1.3","14889"
"부산광역시 중구","Nov-22","9","24012","42001","20778","21223","1.2","14841"
"부산광역시 중구","Dec-22","9","23960","41909","20725","21184","1.2","14809"
"부산광역시 중구","Jan-23","9","23965","41913","20703","21210","1.2","14810"
"부산광역시 중구","Feb-23","9","24123","41957","20738","21219","1.2","14826"
"부산광역시 중구","Jun-22","9","24304","42692","21173","21519","1.3","15086"
"부산광역시 중구","Jul-22","9","24275","42594","21124","21470","1.3","15051"
"부산광역시 중구","Aug-22","9","24265","42455","21055","21400","1.3","15002"
"부산광역시 중구","Sep-22","9","24107","42267","20951","21316","1.3","14935"
"부산광역시 중구","Feb-22","9","24129","42680","21156","21524","1.3","15081"
"부산광역시 중구","Mar-22","9","24218","42725","21157","21568","1.3","15097"
"부산광역시 중구","Apr-22","9","24269","42773","21193","21580","1.3","15114"
"부산광역시 중구","May-22","9","24303","42680","21186","21494","1.3","15081"
"부산광역시 중구","Oct-21","9","23909","42734","21189","21545","1.3","15100"
"부산광역시 중구","Nov-21","9","23898","42602","21119","21483","1.3","15054"
"부산광역시 중구","Dec-21","9","23925","42609","21120","21489","1.3","15056"
"부산광역시 중구","Jan-22","9","23979","42636","21149","21487","1.3","15066"
"부산광역시 중구","Jun-21","9","23583","42619","21140","21479","1.2","15060"
"부산광역시 중구","Jul-21","9","23714","42734","21213","21521","1.3","15100"
"부산광역시 중구","Aug-21","9","23820","42768","21216","21552","1.3","15112"
"부산광역시 중구","Sep-21","9","23878","42760","21217","21543","1.3","15110"
"부산광역시 중구","Jan-21","9","23923","43657","21599","22058","1.3","15427"
"부산광역시 중구","Feb-21","9","24010","43629","21598","22031","1.3","15417"
"부산광역시 중구","Mar-21","9","23951","43438","21511","21927","1.3","15349"
"부산광역시 중구","Apr-21","9","24006","43362","21452","21910","1.3","15322"
"부산광역시 중구","May-21","9","24022","43216","21366","21850","1.3","15271"
"부산광역시 중구","Sep-20","9","23682","43644","21660","21984","1.3","15422"
"부산광역시 중구","Oct-20","9","23723","43648","21652","21996","1.3","15423"
"부산광역시 중구","Nov-20","9","23773","43571","21609","21962","1.3","15396"
"부산광역시 중구","Dec-20","9","23847","43617","21621","21996","1.3","15412"
"부산광역시 중구","Mar-23","9","24099","41862","20698","21164","1.2","14792"
"부산광역시 중구","Apr-23","9","24061","41890","20662","21228","1.2","14802"
"부산광역시 중구","May-23","9","24066","41732","20594","21138","1.2","14746"
"부산광역시 중구","Mar-20","9","23305","44031","21839","22192","1.3","15559"
"부산광역시 중구","Apr-20","9","23313","43931","21791","22140","1.3","15523"
"부산광역시 중구","May-20","9","23406","43835","21755","22080","1.3","15489"
"부산광역시 중구","Jun-20","9","23456","43722","21702","22020","1.3","15449"
"부산광역시 중구","Jul-20","9","23544","43721","21688","22033","1.2","15449"
"부산광역시 중구","Aug-20","9","23626","43691","21663","22028","1.3","15439"
"부산광역시 중구","Oct-19","9","23108","44213","21983","22230","1.3","15623"
"부산광역시 중구","Nov-19","9","23153","44169","21959","22210","1.3","15607"
"부산광역시 중구","Dec-19","9","23160","44072","21904","22168","1.3","15573"
"부산광역시 중구","Jan-20","9","23189","44107","21902","22205","1.3","15586"
"부산광역시 중구","Feb-20","9","23272","44115","21899","22216","1.3","15588"
"부산광역시 중구","May-19","9","23037","44436","22108","22328","1.3","15702"
"부산광역시 중구","Jun-19","9","23082","44474","22101","22373","1.3","15715"
"부산광역시 중구","Jul-19","9","23125","44476","22107","22369","1.3","15716"
"부산광역시 중구","Aug-19","9","23095","44278","22017","22261","1.3","15646"
"부산광역시 중구","Sep-19","9","23093","44223","21987","22236","1.3","15627"
"부산광역시 중구","2018","9","23025","45121","22413","22708","1.3","15944"
"부산광역시 중구","2018","9","23017","45064","22387","22677","1.3","15924"
"부산광역시 중구","Jan-19","9","22953","44734","22212","22522","1.3","15807"
"부산광역시 중구","Feb-19","9","23017","44673","22194","22479","1.3","15786"
"부산광역시 중구","Mar-19","9","23043","44635","22163","22472","1.3","15772"
"부산광역시 중구","Apr-19","9","23051","44575","22152","22423","1.3","15751"
"부산광역시 중구","2018","9","23006","44952","22330","22622","1.3","15884"
"부산광역시 중구","2018","9","22975","44852","22255","22597","1.3","15849"
"부산광역시 중구","2018","9","23232","45788","22731","23057","1.3","16180"
"부산광역시 중구","2018","9","23207","45698","22669","23029","1.3","16148"
"부산광역시 중구","2018","9","23173","45571","22603","22968","1.3","16103"
"부산광역시 중구","2017","9","23284","46066","22843","23223","1.3","16278"
"부산광역시 중구","2018","9","23265","45965","22793","23172","1.3","16242"
"부산광역시 중구","2018","9","23235","45821","22748","23073","1.3","16191"
"부산광역시 중구","2018","9","23089","45408","22524","22884","1.3","16045"
"부산광역시 중구","2018","9","23043","45278","22495","22783","1.3","15999"
"부산광역시 중구","2018","9","23001","45026","22373","22653","1.3","15910"
"부산광역시 중구","2017","9","23262","46729","23192","23537","1.3","16512"
"부산광역시 중구","2017","9","23296","46682","23131","23551","1.3","16495"
"부산광역시 중구","2017","9","23300","46584","23096","23488","1.3","16461"
"부산광역시 중구","2017","9","23301","46479","23065","23414","1.3","16424"
"부산광역시 중구","2017","9","23282","46323","22971","23352","1.3","16391"
"부산광역시 중구","2017","9","23281","46169","22901","23268","1.3","16337"
"부산광역시 중구","2017","9","23333","46538","23072","23466","1.3","16445"
"부산광역시 중구","2017","9","23261","47061","23389","23672","1.3","16629"
"부산광역시 중구","2017","9","23287","46989","23340","23649","1.3","16604"
"부산광역시 중구","2017","9","23291","46975","23348","23627","1.3","16599"
"부산광역시 중구","2017","9","23271","46838","23259","23579","1.3","16551"
"부산광역시 중구","2012","9","23309","49407","24540","24867","1.38","17458"
"부산광역시 중구","2013","9","23374","48614","24206","24408","1.36","17178"
"부산광역시 중구","2014","9","23493","48058","23949","24109","1.35","16982"
"부산광역시 중구","2015","9","23295","47530","23598","23932","1.3","16795"
"부산광역시 중구","2016","9","23282","47117","23414","23703","1.3","16649"
"부산광역시 중구","2017","9","23284","46066","22843","23223","1.3","16278"
"부산광역시 중구","2007","9","21595","50932","25067","25865","1.41","18190"
"부산광역시 중구","2008","9","21920","50602","24973","25629","1.41","17960"
"부산광역시 중구","2009","9","22064","49983","24805","25178","1.4","17724"
"부산광역시 중구","2010","9","23266","50555","25055","25500","1.4","17927"
"부산광역시 중구","2011","9","23284","49859","24761","25098","1.39","17680"
"부산광역시 영도구","Oct-22","11","54440","110574","54641","55933","3.3","7787"
"부산광역시 영도구","Nov-22","11","54362","110386","54570","55816","3.3","7774"
"부산광역시 영도구","Dec-22","11","54342","110254","54498","55756","3.3","7764"
"부산광역시 영도구","Jan-23","11","54304","110063","54398","55665","3.3","7751"
"부산광역시 영도구","Jun-22","11","54700","111307","55055","56252","3.3","7839"
"부산광역시 영도구","Jul-22","11","54725","111271","55039","56232","3.3","7836"
"부산광역시 영도구","Aug-22","11","54711","111100","54973","56127","3.3","7824"
"부산광역시 영도구","Sep-22","11","54474","110813","54787","56026","3.3","7804"
"부산광역시 영도구","Feb-22","11","54560","111807","55305","56502","3.3","7874"
"부산광역시 영도구","Mar-22","11","54518","111479","55151","56328","3.3","7851"
"부산광역시 영도구","Apr-22","11","54478","111254","55011","56243","3.3","7835"
"부산광역시 영도구","May-22","11","54650","111321","55051","56270","3.3","7840"
"부산광역시 영도구","Oct-21","11","54721","112928","55813","57115","3.3","7953"
"부산광역시 영도구","Nov-21","11","54721","112715","55720","56995","3.3","7938"
"부산광역시 영도구","Dec-21","11","54659","112451","55576","56875","3.3","7919"
"부산광역시 영도구","Jan-22","11","54609","112237","55482","56755","3.3","7904"
"부산광역시 영도구","Jun-21","11","54568","113510","56185","57325","3.3","7994"
"부산광역시 영도구","Jul-21","11","54643","113411","56127","57284","3.3","7987"
"부산광역시 영도구","Aug-21","11","54681","113193","55995","57198","3.3","7971"
"부산광역시 영도구","Sep-21","11","54701","113026","55895","57131","3.3","7960"
"부산광역시 영도구","Jan-21","11","54905","114844","56803","58041","3.3","8088"
"부산광역시 영도구","Feb-21","11","54936","114636","56704","57932","3.3","8073"
"부산광역시 영도구","Mar-21","11","54048","113332","56124","57208","3.3","7981"
"부산광역시 영도구","Apr-21","11","54141","113204","56078","57126","3.3","7972"
"부산광역시 영도구","May-21","11","54388","113378","56123","57255","3.3","7984"
"부산광역시 영도구","Sep-20","11","54896","116212","57502","58710","3.4","8184"
"부산광역시 영도구","Oct-20","11","54876","115852","57322","58530","3.4","8159"
"부산광역시 영도구","Nov-20","11","54896","115513","57142","58371","3.4","8135"
"부산광역시 영도구","Dec-20","11","54903","115144","56953","58191","3.3","8109"
"부산광역시 영도구","Feb-23","11","54322","109865","54304","55561","3.3","7737"
"부산광역시 영도구","Mar-23","11","54335","109774","54241","55533","3.3","7731"
"부산광역시 영도구","Apr-23","11","54299","109553","54131","55422","3.3","7715"
"부산광역시 영도구","May-23","11","54248","109412","54070","55342","3.3","7705"
"부산광역시 영도구","Mar-20","11","54837","117765","58299","59466","3.4","8293"
"부산광역시 영도구","Apr-20","11","54812","117469","58138","59331","3.4","8272"
"부산광역시 영도구","May-20","11","54884","117176","57970","59206","3.4","8252"
"부산광역시 영도구","Jun-20","11","54866","116896","57795","59101","3.4","8232"
"부산광역시 영도구","Jul-20","11","54914","116752","57748","59004","3.3","8222"
"부산광역시 영도구","Aug-20","11","54870","116477","57634","58843","3.4","8203"
"부산광역시 영도구","Oct-19","11","54928","119244","59125","60119","3.4","8397"
"부산광역시 영도구","Nov-19","11","54909","118962","58960","60002","3.4","8378"
"부산광역시 영도구","Dec-19","11","54859","118628","58806","59822","3.4","8354"
"부산광역시 영도구","Jan-20","11","54852","118353","58647","59706","3.4","8335"
"부산광역시 영도구","Feb-20","11","54824","118055","58463","59592","3.4","8314"
"부산광역시 영도구","May-19","11","55197","120651","59810","60841","3.5","8497"
"부산광역시 영도구","Jun-19","11","55185","120451","59711","60740","3.5","8482"
"부산광역시 영도구","Jul-19","11","55145","120174","59570","60604","3.5","8463"
"부산광역시 영도구","Aug-19","11","55090","119870","59422","60448","3.4","8442"
"부산광역시 영도구","Sep-19","11","55018","119602","59289","60313","3.4","8423"
"부산광역시 영도구","2018","11","55411","123118","61154","61964","3.5","8676"
"부산광역시 영도구","2018","11","55415","122920","61043","61877","3.5","8662"
"부산광역시 영도구","Jan-19","11","55243","121540","60314","61226","3.5","8559"
"부산광역시 영도구","Feb-19","11","55237","121302","60189","61113","3.5","8542"
"부산광역시 영도구","Mar-19","11","55222","121063","60039","61024","3.5","8526"
"부산광역시 영도구","Apr-19","11","55196","120912","59959","60953","3.5","8515"
"부산광역시 영도구","2018","11","55340","122219","60701","61518","3.5","8613"
"부산광역시 영도구","2018","11","55312","121934","60554","61380","3.5","8587"
"부산광역시 영도구","2018","11","55696","124655","61900","62755","3.5","8785"
"부산광역시 영도구","2018","11","55651","124343","61731","62612","3.5","8763"
"부산광역시 영도구","2018","11","55578","123963","61557","62406","3.5","8736"
"부산광역시 영도구","2017","11","55713","125347","62284","63063","3.6","8833"
"부산광역시 영도구","2018","11","55710","125140","62173","62967","3.6","8819"
"부산광역시 영도구","2018","11","55720","124918","62046","62872","3.6","8803"
"부산광역시 영도구","2018","11","55534","123735","61454","62281","3.5","8720"
"부산광역시 영도구","2018","11","55445","123408","61279","62129","3.5","8697"
"부산광역시 영도구","2018","11","55399","122497","60828","61669","3.5","8633"
"부산광역시 영도구","2017","11","55559","126499","62903","63596","3.6","8915"
"부산광역시 영도구","2017","11","55521","126303","62832","63471","3.6","8901"
"부산광역시 영도구","2017","11","55514","126081","62715","63366","3.6","8885"
"부산광역시 영도구","2017","11","55632","125889","62588","63301","3.6","8872"
"부산광역시 영도구","2017","11","55651","125698","62483","63215","3.6","8855"
"부산광역시 영도구","2017","11","55661","125487","62345","63142","3.6","8840"
"부산광역시 영도구","2017","11","55546","125905","62628","63277","3.6","8873"
"부산광역시 영도구","2017","11","55807","127871","63597","64274","3.6","9011"
"부산광역시 영도구","2017","11","55750","127476","63421","64055","3.6","8984"
"부산광역시 영도구","2017","11","55672","127176","63248","63928","3.6","8962"
"부산광역시 영도구","2017","11","55608","126884","63104","63780","3.6","8942"
"부산광역시 영도구","2013","11","57277","137437","68619","68818","3.86","9727"
"부산광역시 영도구","2014","11","56580","133750","66691","67059","3.76","9452"
"부산광역시 영도구","2015","11","56446","131251","65359","65892","3.7","9276"
"부산광역시 영도구","2016","11","55893","128259","63775","64484","3.6","9039"
"부산광역시 영도구","2017","11","55713","125347","62284","63063","3.6","8833"
"부산광역시 영도구","2007","11","57914","156661","78466","78195","4.33","11158"
"부산광역시 영도구","2008","11","57948","153802","77012","76790","4.28","10908"
"부산광역시 영도구","2009","11","57651","149787","74937","74850","4.19","10601"
"부산광역시 영도구","2010","11","59147","148431","74259","74172","4.12","10505"
"부산광역시 영도구","2011","11","58584","144884","72409","72475","4.04","10254"
"부산광역시 영도구","2012","11","57900","141422","70643","70779","3.96","10009"
"부산광역시 연제구","Oct-22","12","93706","205309","98432","106877","6.1","16968"
"부산광역시 연제구","Nov-22","12","93581","204819","98167","106652","6.1","16927"
"부산광역시 연제구","Dec-22","12","93557","204504","97988","106516","6.1","16901"
"부산광역시 연제구","Jan-23","12","93490","204173","97821","106352","6.1","16874"
"부산광역시 연제구","Jun-22","12","94167","207060","99451","107609","6.1","17112"
"부산광역시 연제구","Jul-22","12","94147","206812","99295","107517","6.1","17092"
"부산광역시 연제구","Aug-22","12","94136","206433","99077","107356","6.1","17061"
"부산광역시 연제구","Sep-22","12","93840","205804","98703","107101","6.1","17009"
"부산광역시 연제구","Jan-22","12","93890","208255","100213","108042","6.1","17211"
"부산광역시 연제구","Feb-22","12","94026","208090","100065","108025","6.1","17198"
"부산광역시 연제구","Mar-22","12","94091","207847","99905","107942","6.1","17177"
"부산광역시 연제구","Apr-22","12","94123","207592","99716","107876","6.1","17156"
"부산광역시 연제구","May-22","12","94182","207425","99622","107803","6.1","17143"
"부산광역시 연제구","Sep-21","12","92451","206585","99349","107236","6.1","17073"
"부산광역시 연제구","Oct-21","12","92572","206511","99339","107172","6.1","17067"
"부산광역시 연제구","Nov-21","12","92850","206649","99389","107260","6.1","17078"
"부산광역시 연제구","Dec-21","12","93606","208050","100107","107943","6.1","17194"
"부산광역시 연제구","May-21","12","92100","207472","99817","107655","6.1","17146"
"부산광역시 연제구","Jun-21","12","92165","207173","99637","107536","6.1","17122"
"부산광역시 연제구","Jul-21","12","92192","206864","99444","107420","6.1","17096"
"부산광역시 연제구","Aug-21","12","92236","206624","99365","107259","6.1","17076"
"부산광역시 연제구","Jan-21","12","92694","209856","100913","108943","6.1","17343"
"부산광역시 연제구","Feb-21","12","92851","209692","100802","108890","6.1","17330"
"부산광역시 연제구","Mar-21","12","92104","208352","100297","108055","6.1","17219"
"부산광역시 연제구","Apr-21","12","92091","207912","100048","107864","6.1","17183"
"부산광역시 연제구","Aug-20","12","92154","211128","101701","109427","6.1","17449"
"부산광역시 연제구","Sep-20","12","92418","211344","101768","109576","6.1","17466"
"부산광역시 연제구","Oct-20","12","92475","211175","101675","109500","6.1","17452"
"부산광역시 연제구","Nov-20","12","92535","210666","101381","109285","6.1","17410"
"부산광역시 연제구","Dec-20","12","92583","210128","101055","109073","6.1","17366"
"부산광역시 연제구","Feb-23","12","93538","204025","97696","106329","6.1","16862"
"부산광역시 연제구","Mar-23","12","93650","204094","97715","106379","6.1","16867"
"부산광역시 연제구","Apr-23","12","93724","204073","97695","106378","6.1","16866"
"부산광역시 연제구","May-23","12","93852","204023","97637","106386","6.1","16861"
"부산광역시 연제구","Apr-20","12","91122","211136","101828","109308","6.1","17449"
"부산광역시 연제구","May-20","12","91287","210893","101643","109250","6.1","17429"
"부산광역시 연제구","Jun-20","12","91412","210515","101437","109078","6.1","17398"
"부산광역시 연제구","Jul-20","12","91608","210336","101353","108983","6","17383"
"부산광역시 연제구","Sep-19","12","89916","210393","101605","108788","6.1","17388"
"부산광역시 연제구","Oct-19","12","90068","210565","101705","108860","6.1","17402"
"부산광역시 연제구","Nov-19","12","90131","210584","101767","108817","6.1","17404"
"부산광역시 연제구","Dec-19","12","90266","210443","101654","108789","6.1","17392"
"부산광역시 연제구","Jan-20","12","90601","211026","101888","109138","6.1","17440"
"부산광역시 연제구","Feb-20","12","90948","211562","102142","109420","6.1","17484"
"부산광역시 연제구","Mar-20","12","91106","211385","101999","109386","6.1","17470"
"부산광역시 연제구","Apr-19","12","89325","210736","101963","108773","6","17416"
"부산광역시 연제구","May-19","12","89722","211258","102148","109110","6.1","17459"
"부산광역시 연제구","Jun-19","12","89777","211051","101977","109074","6.1","17442"
"부산광역시 연제구","Jul-19","12","89807","210876","101904","108972","6.1","17428"
"부산광역시 연제구","Aug-19","12","89873","210572","101736","108836","6.1","17403"
"부산광역시 연제구","2018","12","86155","206054","99961","106093","5.9","17029"
"부산광역시 연제구","2018","12","86246","205925","99876","106049","5.9","17019"
"부산광역시 연제구","Jan-19","12","88261","209412","101400","108012","6","17307"
"부산광역시 연제구","Feb-19","12","88520","209641","101496","108145","6","17326"
"부산광역시 연제구","Mar-19","12","88757","209846","101552","108294","6","17343"
"부산광역시 연제구","2018","12","86642","206494","100136","106358","5.9","17066"
"부산광역시 연제구","2018","12","87338","207837","100745","107092","5.9","17177"
"부산광역시 연제구","2018","12","87833","208844","101171","107673","6","17260"
"부산광역시 연제구","2018","12","86070","207396","100757","106639","5.9","17140"
"부산광역시 연제구","2018","12","86036","206953","100495","106458","5.9","17104"
"부산광역시 연제구","2018","12","85983","206667","100353","106314","5.9","17080"
"부산광역시 연제구","2018","12","86080","206207","100062","106145","5.9","17042"
"부산광역시 연제구","2017","12","85792","207828","101077","106751","5.9","17177"
"부산광역시 연제구","2018","12","86013","207717","100965","106752","5.9","17167"
"부산광역시 연제구","2018","12","86005","206424","100209","106215","5.9","17060"
"부산광역시 연제구","2018","12","86046","206259","100116","106143","5.9","17046"
"부산광역시 연제구","2017","12","85133","208190","101389","106801","5.9","17206"
"부산광역시 연제구","2017","12","85196","208077","101345","106732","5.9","17196"
"부산광역시 연제구","2017","12","85419","208350","101426","106924","5.9","17219"
"부산광역시 연제구","2017","12","85701","208423","101399","107024","5.9","17225"
"부산광역시 연제구","2017","12","85731","208055","101193","106862","5.9","17196"
"부산광역시 연제구","2017","12","85580","208468","101418","107050","5.9","17229"
"부산광역시 연제구","2017","12","84446","208147","101629","106518","5.9","17202"
"부산광역시 연제구","2017","12","84949","208679","101770","106909","5.9","17246"
"부산광역시 연제구","2017","12","85892","207729","100988","106741","5.9","17168"
"부산광역시 연제구","2017","12","85053","208548","101657","106891","5.9","17235"
"부산광역시 연제구","2017","12","85036","208298","101464","106834","5.9","17215"
"부산광역시 연제구","2012","12","82161","212326","104791","107535","5.94","17577"
"부산광역시 연제구","2013","12","82467","210043","103443","106600","5.89","17388"
"부산광역시 연제구","2014","12","83188","208787","102697","106090","5.87","17284"
"부산광역시 연제구","2015","12","84543","211645","103885","107760","5.9","17520"
"부산광역시 연제구","2016","12","84398","208211","101692","106519","5.9","17208"
"부산광역시 연제구","2017","12","85892","207729","100988","106741","5.9","17168"
"부산광역시 연제구","2007","13","76197","213435","105607","107828","5.9","17668"
"부산광역시 연제구","2008","12","77326","213698","105578","108120","5.94","17693"
"부산광역시 연제구","2009","12","77490","211184","104467","106717","5.91","17482"
"부산광역시 연제구","2010","12","80824","213453","105533","107920","5.93","17670"
"부산광역시 연제구","2011","12","82005","214131","105803","108328","5.97","17726"
"부산광역시 수영구","Oct-22","10","87311","176481","82974","93507","5.2","17268"
"부산광역시 수영구","Nov-22","10","87360","176704","83024","93680","5.2","17290"
"부산광역시 수영구","Dec-22","10","87361","176615","82951","93664","5.2","17281"
"부산광역시 수영구","Jan-23","10","87487","176725","82964","93761","5.3","17292"
"부산광역시 수영구","May-22","10","86829","176398","83060","93338","5.2","17260"
"부산광역시 수영구","Jun-22","10","86992","176490","83094","93396","5.2","17269"
"부산광역시 수영구","Jul-22","10","87128","176476","83055","93421","5.2","17268"
"부산광역시 수영구","Aug-22","10","87245","176370","82976","93394","5.2","17257"
"부산광역시 수영구","Sep-22","10","87065","176074","82810","93264","5.2","17228"
"부산광역시 수영구","Jan-22","10","86014","176586","83261","93325","5.2","17278"
"부산광역시 수영구","Feb-22","10","86261","176542","83210","93332","5.2","17274"
"부산광역시 수영구","Mar-22","10","86445","176361","83049","93312","5.2","17256"
"부산광역시 수영구","Apr-22","10","86584","176350","83040","93310","5.2","17255"
"부산광역시 수영구","Sep-21","10","85573","177537","83785","93752","5.2","17389"
"부산광역시 수영구","Oct-21","10","85693","177319","83679","93640","5.2","17367"
"부산광역시 수영구","Nov-21","10","85830","177120","83560","93560","5.2","17348"
"부산광역시 수영구","Dec-21","10","85896","176812","83375","93437","5.2","17301"
"부산광역시 수영구","May-21","10","84790","177739","83958","93781","5.2","17408"
"부산광역시 수영구","Jun-21","10","84948","177568","83819","93749","5.2","17392"
"부산광역시 수영구","Jul-21","10","85083","177424","83772","93652","5.2","17377"
"부산광역시 수영구","Aug-21","10","85343","177520","83797","93723","5.2","17387"
"부산광역시 수영구","Jan-21","10","84460","178441","84273","94168","5.2","17477"
"부산광역시 수영구","Feb-21","10","84736","178389","84261","94128","5.2","17472"
"부산광역시 수영구","Mar-21","10","84569","177833","84027","93806","5.2","17418"
"부산광역시 수영구","Apr-21","10","84717","177962","84067","93895","5.2","17430"
"부산광역시 수영구","Aug-20","10","83579","178642","84444","94198","5.2","17497"
"부산광역시 수영구","Sep-20","10","83906","178975","84598","94377","5.2","17529"
"부산광역시 수영구","Oct-20","10","83941","178782","84459","94323","5.2","17510"
"부산광역시 수영구","Nov-20","10","84049","178576","84335","94241","5.2","17490"
"부산광역시 수영구","Dec-20","10","84311","178589","84332","94257","5.2","17492"
"부산광역시 수영구","Feb-23","10","87774","176992","83067","93925","5.3","17318"
"부산광역시 수영구","Mar-23","10","87985","177230","83140","94090","5.3","17341"
"부산광역시 수영구","Apr-23","10","88084","177271","83151","94120","5.3","17345"
"부산광역시 수영구","May-23","10","88211","177368","83143","94225","5.3","17355"
"부산광역시 수영구","Mar-20","10","82334","178715","84577","94138","5.2","17504"
"부산광역시 수영구","Apr-20","10","82464","178722","84504","94218","5.2","17505"
"부산광역시 수영구","May-20","10","82670","178605","84422","94183","5.2","17493"
"부산광역시 수영구","Jun-20","10","82989","178702","84448","94254","5.2","17503"
"부산광역시 수영구","Jul-20","10","83207","178463","84334","94129","5.1","17479"
"부산광역시 수영구","Sep-19","10","81323","178484","84716","93768","5.1","17481"
"부산광역시 수영구","Oct-19","10","81332","178274","84599","93675","5.1","17461"
"부산광역시 수영구","Nov-19","10","81385","178071","84518","93553","5.1","17441"
"부산광역시 수영구","Dec-19","10","81452","177897","84349","93548","5.1","17424"
"부산광역시 수영구","Jan-20","10","81608","177861","84307","93554","5.1","17420"
"부산광역시 수영구","Feb-20","10","82083","178637","84582","94055","5.2","17496"
"부산광역시 수영구","Apr-19","10","80194","177437","84280","93157","5.1","17379"
"부산광역시 수영구","May-19","10","80273","177230","84178","93052","5.1","17358"
"부산광역시 수영구","Jun-19","10","80727","178009","84522","93487","5.1","17435"
"부산광역시 수영구","Jul-19","10","81059","178432","84750","93682","5.1","17476"
"부산광역시 수영구","Aug-19","10","81264","178514","84761","93753","5.1","17484"
"부산광역시 수영구","2018","10","79662","179164","85225","93939","5.1","17548"
"부산광역시 수영구","2018","10","79732","179003","85111","93892","5.1","17532"
"부산광역시 수영구","2018","10","79842","178028","84683","93345","5.1","17437"
"부산광역시 수영구","Jan-19","10","79912","177882","84570","93312","5.1","17422"
"부산광역시 수영구","Feb-19","10","80050","177849","84539","93310","5.1","17419"
"부산광역시 수영구","Mar-19","10","80138","177795","84444","93351","5.1","17414"
"부산광역시 수영구","2018","10","79776","178502","84921","93581","5.1","17483"
"부산광역시 수영구","2018","10","79730","178150","84769","93381","5.1","17449"
"부산광역시 수영구","2018","10","80019","181526","86496","95030","5.2","17779"
"부산광역시 수영구","2018","10","80017","181051","86239","94812","5.2","17733"
"부산광역시 수영구","2018","10","80001","180703","86021","94682","5.1","17699"
"부산광역시 수영구","2017","10","79563","181629","86521","95108","5.2","17797"
"부산광역시 수영구","2018","10","79922","181605","86556","95049","5.2","17787"
"부산광역시 수영구","2018","10","79890","180211","85787","94424","5.1","17650"
"부산광역시 수영구","2018","10","79756","179631","85459","94172","5.1","17594"
"부산광역시 수영구","2018","10","79752","178815","85075","93740","5.1","17514"
"부산광역시 수영구","2017","10","78255","180242","85978","94264","5.1","17653"
"부산광역시 수영구","2017","10","78398","180178","85904","94274","5.1","17647"
"부산광역시 수영구","2017","10","78554","180133","85890","94243","5.1","17643"
"부산광역시 수영구","2017","10","79238","181236","86353","94883","5.1","17751"
"부산광역시 수영구","2017","10","79384","181466","86426","95040","5.1","17781"
"부산광역시 수영구","2017","10","78847","180583","86060","94523","5.1","17687"
"부산광역시 수영구","2017","10","79788","181725","86570","95155","5.2","17799"
"부산광역시 수영구","2017","10","77754","180803","86203","94600","5.1","17708"
"부산광역시 수영구","2017","10","77696","180222","85911","94311","5.1","17652"
"부산광역시 수영구","2017","10","79788","181725","86570","95155","5.2","17799"
"부산광역시 수영구","2017","10","77820","179963","85781","94182","5.1","17626"
"부산광역시 수영구","2017","10","77979","180085","85883","94202","5.1","17638"
"부산광역시 수영구","2012","10","71183","177678","85673","92005","4.97","17402"
"부산광역시 수영구","2013","10","71790","176156","84855","91301","4.94","17253"
"부산광역시 수영구","2014","10","74356","179620","86314","93306","5.05","17593"
"부산광역시 수영구","2015","10","76325","181397","86798","94599","5.1","17767"
"부산광역시 수영구","2016","10","77733","181016","86332","94684","5.1","17729"
"부산광역시 수영구","2007","10","65458","179100","86942","92158","4.95","17542"
"부산광역시 수영구","2008","10","65932","178092","86493","91599","4.95","17454"
"부산광역시 수영구","2009","10","66948","178231","86330","91901","4.99","17474"
"부산광역시 수영구","2010","10","69633","179208","86705","92503","4.98","17569"
"부산광역시 수영구","2011","10","70314","177676","85764","91912","4.95","17419"
"부산광역시 서구","Oct-22","13","53657","107490","52192","55298","3.2","7705"
"부산광역시 서구","Nov-22","13","53648","107476","52170","55306","3.2","7704"
"부산광역시 서구","Dec-22","13","53626","107402","52118","55284","3.2","7699"
"부산광역시 서구","Jan-23","13","53592","107255","52035","55220","3.2","7689"
"부산광역시 서구","Jun-22","13","53109","106397","51630","54767","3.1","7627"
"부산광역시 서구","Jul-22","13","53342","106818","51834","54984","3.2","7657"
"부산광역시 서구","Aug-22","13","53667","107522","52184","55338","3.2","7708"
"부산광역시 서구","Sep-22","13","53621","107514","52202","55312","3.2","7707"
"부산광역시 서구","Feb-22","13","52900","106634","51836","54798","3.1","7644"
"부산광역시 서구","Mar-22","13","52895","106334","51687","54647","3.1","7623"
"부산광역시 서구","Apr-22","13","52822","105963","51487","54476","3.1","7596"
"부산광역시 서구","May-22","13","52852","105851","51389","54462","3.1","7588"
"부산광역시 서구","Oct-21","13","53038","107536","52275","55261","3.2","7703"
"부산광역시 서구","Nov-21","13","53019","107381","52178","55203","3.2","7692"
"부산광역시 서구","Dec-21","13","52960","107143","52051","55092","3.2","7681"
"부산광역시 서구","Jan-22","13","52853","106863","51951","54912","3.1","7660"
"부산광역시 서구","Jun-21","13","53133","108383","52665","55718","3.2","7764"
"부산광역시 서구","Jul-21","13","53159","108279","52647","55632","3.2","7756"
"부산광역시 서구","Aug-21","13","53095","107976","52498","55478","3.2","7735"
"부산광역시 서구","Sep-21","13","53097","107787","52395","55392","3.2","7721"
"부산광역시 서구","Jan-21","13","53881","109876","53464","56412","3.2","7871"
"부산광역시 서구","Feb-21","13","53962","109759","53367","56392","3.2","7862"
"부산광역시 서구","Mar-21","13","52876","108375","52726","55649","3.2","7763"
"부산광역시 서구","Apr-21","13","53018","108453","52738","55715","3.2","7769"
"부산광역시 서구","May-21","13","53115","108450","52686","55764","3.2","7769"
"부산광역시 서구","Sep-20","13","53359","109614","53381","56233","3.2","7841"
"부산광역시 서구","Oct-20","13","53576","109916","53502","56414","3.2","7862"
"부산광역시 서구","Nov-20","13","53724","110027","53535","56492","3.2","7870"
"부산광역시 서구","Dec-20","13","53853","110051","53521","56530","3.2","7883"
"부산광역시 서구","Feb-23","13","53689","107209","51973","55236","3.2","7685"
"부산광역시 서구","Mar-23","13","53670","107035","51815","55220","3.2","7673"
"부산광역시 서구","Apr-23","13","53640","106977","51760","55217","3.2","7669"
"부산광역시 서구","May-23","13","53593","106877","51671","55206","3.2","7661"
"부산광역시 서구","Mar-20","13","52792","109756","53507","56249","3.2","7851"
"부산광역시 서구","Apr-20","13","52884","109730","53489","56241","3.2","7849"
"부산광역시 서구","May-20","13","53072","109820","53529","56291","3.2","7856"
"부산광역시 서구","Jun-20","13","53248","109885","53544","56341","3.2","7860"
"부산광역시 서구","Jul-20","13","53340","109870","53519","56351","3.1","7859"
"부산광역시 서구","Aug-20","13","53342","109691","53411","56280","3.2","7846"
"부산광역시 서구","Oct-19","13","52890","110821","54171","56650","3.2","7927"
"부산광역시 서구","Nov-19","13","52819","110576","54053","56523","3.2","7910"
"부산광역시 서구","Dec-19","13","52786","110350","53941","56409","3.2","7893"
"부산광역시 서구","Jan-20","13","52735","110097","53795","56302","3.2","7875"
"부산광역시 서구","Feb-20","13","52806","109971","53679","56292","3.2","7866"
"부산광역시 서구","May-19","13","53055","111861","54761","57100","3.2","8002"
"부산광역시 서구","Jun-19","13","52994","111617","54603","57014","3.2","7984"
"부산광역시 서구","Jul-19","13","52975","111495","54531","56964","3.2","7975"
"부산광역시 서구","Aug-19","13","52908","111226","54372","56854","3.2","7956"
"부산광역시 서구","Sep-19","13","52914","111044","54263","56781","3.2","7943"
"부산광역시 서구","2018","13","52642","112620","55272","57348","3.2","8056"
"부산광역시 서구","2018","13","52686","112667","55306","57361","3.2","8059"
"부산광역시 서구","Jan-19","13","52826","112497","55270","57227","3.2","8047"
"부산광역시 서구","Feb-19","13","52967","112465","55202","57263","3.2","8045"
"부산광역시 서구","Mar-19","13","53074","112376","55087","57289","3.2","8038"
"부산광역시 서구","Apr-19","13","53059","112094","54889","57205","3.2","8018"
"부산광역시 서구","2018","13","52801","112759","55369","57390","3.2","8066"
"부산광역시 서구","2018","13","52819","112621","55327","57294","3.2","8056"
"부산광역시 서구","2018","13","52083","111781","54986","56795","3.2","7996"
"부산광역시 서구","2018","13","52129","111612","54873","56739","3.2","7984"
"부산광역시 서구","2018","13","52341","112109","55099","57010","3.2","8019"
"부산광역시 서구","2017","13","51953","111945","55081","56864","3.2","8008"
"부산광역시 서구","2018","13","51900","111682","54949","56733","3.2","7989"
"부산광역시 서구","2018","13","52061","111906","55036","56870","3.2","8005"
"부산광역시 서구","2018","13","52500","112445","55220","57225","3.2","8043"
"부산광역시 서구","2018","13","52581","112550","55244","57306","3.2","8051"
"부산광역시 서구","2018","13","52778","112771","55362","57409","3.2","8067"
"부산광역시 서구","2017","13","52338","113512","55877","57635","3.2","8131"
"부산광역시 서구","2017","13","52276","113333","55834","57499","3.2","8118"
"부산광역시 서구","2017","13","52285","113198","55753","57445","3.2","8109"
"부산광역시 서구","2017","13","52231","112881","55592","57289","3.2","8086"
"부산광역시 서구","2017","13","52184","112658","55491","57167","3.2","8071"
"부산광역시 서구","2017","13","52073","112345","55298","57047","3.2","8049"
"부산광역시 서구","2017","13","52300","113069","55681","57388","3.2","8099"
"부산광역시 서구","2017","13","52426","114400","56399","58001","3.2","8195"
"부산광역시 서구","2017","13","52469","114144","56215","57929","3.2","8177"
"부산광역시 서구","2017","13","52409","113898","56085","57813","3.2","8159"
"부산광역시 서구","2017","13","52352","113648","55952","57696","3.2","8141"
"부산광역시 서구","2013","13","53031","120044","59544","60500","3.37","8618"
"부산광역시 서구","2014","13","53417","119506","59122","60384","3.36","8579"
"부산광역시 서구","2015","13","53199","117608","58075","59533","3.3","8443"
"부산광역시 서구","2016","13","52497","114752","56611","58141","3.2","8220"
"부산광역시 서구","2017","13","51953","111945","55081","56864","3.2","8008"
"부산광역시 서구","2007","14","52275","133666","66481","67185","3.7","9735"
"부산광역시 서구","2008","14","51755","130402","64889","65513","3.63","9423"
"부산광역시 서구","2009","13","51490","126811","63146","63665","3.55","9156"
"부산광역시 서구","2010","13","53783","127068","63132","63936","3.53","9155"
"부산광역시 서구","2011","13","53585","124824","61943","62881","3.48","8993"
"부산광역시 서구","2012","13","53138","122040","60585","61455","3.42","8793"
"부산광역시 사하구","Oct-22","16","140904","307196","153035","154161","9.1","7354"
"부산광역시 사하구","Nov-22","16","140839","306893","152924","153969","9.1","7347"
"부산광역시 사하구","Dec-22","16","140778","306511","152728","153783","9.1","7338"
"부산광역시 사하구","Jan-23","16","140814","306473","152722","153751","9.1","7337"
"부산광역시 사하구","Jun-22","16","141003","309199","154125","155074","9.1","7402"
"부산광역시 사하구","Jul-22","16","141082","308777","153906","154871","9.1","7392"
"부산광역시 사하구","Aug-22","16","141176","308286","153638","154648","9.1","7381"
"부산광역시 사하구","Sep-22","16","140869","307465","153183","154282","9.1","7361"
"부산광역시 사하구","Feb-22","16","140385","310274","154680","155594","9.1","7428"
"부산광역시 사하구","Mar-22","16","140594","309924","154517","155407","9.1","7420"
"부산광역시 사하구","Apr-22","16","140807","309718","154399","155319","9.1","7415"
"부산광역시 사하구","May-22","16","140991","309583","154369","155214","9.1","7412"
"부산광역시 사하구","Sep-21","16","139174","311091","155259","155832","9.1","7448"
"부산광역시 사하구","Oct-21","16","139393","310836","155076","155760","9.1","7442"
"부산광역시 사하구","Nov-21","16","139558","310651","154977","155674","9.1","7437"
"부산광역시 사하구","Dec-21","16","139604","310195","154681","155514","9.1","7426"
"부산광역시 사하구","Jan-22","16","139856","310108","154597","155511","9.1","7424"
"부산광역시 사하구","May-21","16","138530","312377","156022","156355","9.2","7479"
"부산광역시 사하구","Jun-21","16","138589","311859","155713","156146","9.1","7466"
"부산광역시 사하구","Jul-21","16","138547","311146","155337","155809","9.1","7449"
"부산광역시 사하구","Aug-21","16","138893","311154","155328","155826","9.1","7449"
"부산광역시 사하구","Jan-21","16","138852","315489","157568","157921","9.2","7553"
"부산광역시 사하구","Feb-21","16","139159","315140","157418","157722","9.2","7545"
"부산광역시 사하구","Mar-21","16","138478","313704","156712","156992","9.2","7510"
"부산광역시 사하구","Apr-21","16","138475","313036","156337","156699","9.2","7494"
"부산광역시 사하구","Sep-20","16","139047","319277","159550","159727","9.3","7644"
"부산광역시 사하구","Oct-20","16","138879","318206","158944","159262","9.2","7618"
"부산광역시 사하구","Nov-20","16","138906","317333","158470","158863","9.2","7597"
"부산광역시 사하구","Dec-20","16","138854","316226","157924","158302","9.2","7571"
"부산광역시 사하구","Feb-23","16","141291","306635","152804","153831","9.1","7341"
"부산광역시 사하구","Mar-23","16","141398","306547","152712","153835","9.1","7339"
"부산광역시 사하구","Apr-23","16","141450","306358","152578","153780","9.1","7334"
"부산광역시 사하구","May-23","16","141510","306147","152407","153740","9.1","7329"
"부산광역시 사하구","Apr-20","16","138813","322960","161595","161365","9.3","7732"
"부산광역시 사하구","May-20","16","138962","322439","161281","161158","9.3","7719"
"부산광역시 사하구","Jun-20","16","139108","321916","161035","160881","9.3","7707"
"부산광역시 사하구","Jul-20","16","139163","321352","160716","160636","9.3","7693"
"부산광역시 사하구","Aug-20","16","139139","320351","160190","160161","9.3","7669"
"부산광역시 사하구","Oct-19","16","138825","327365","163814","163551","9.4","7837"
"부산광역시 사하구","Nov-19","16","138822","326902","163575","163327","9.4","7826"
"부산광역시 사하구","Dec-19","16","138790","325951","163099","162852","9.4","7803"
"부산광역시 사하구","Jan-20","16","138670","325219","162775","162444","9.4","7786"
"부산광역시 사하구","Feb-20","16","138770","324510","162456","162054","9.4","7769"
"부산광역시 사하구","Mar-20","16","138864","323758","162020","161738","9.4","7751"
"부산광역시 사하구","Apr-19","16","138682","330049","165279","164770","9.5","7902"
"부산광역시 사하구","May-19","16","138744","329550","165035","164515","9.5","7890"
"부산광역시 사하구","Jun-19","16","138780","329194","164840","164354","9.5","7881"
"부산광역시 사하구","Jul-19","16","138807","328895","164670","164225","9.5","7874"
"부산광역시 사하구","Aug-19","16","138795","328331","164365","163966","9.4","7860"
"부산광역시 사하구","Sep-19","16","138817","327956","164143","163813","9.4","7851"
"부산광역시 사하구","2018","16","138468","334737","167839","166898","9.6","7991"
"부산광역시 사하구","2018","16","138546","334573","167724","166849","9.6","7987"
"부산광역시 사하구","Jan-19","16","138403","331913","166344","165569","9.5","7946"
"부산광역시 사하구","Feb-19","16","138418","330928","165817","165111","9.5","7923"
"부산광역시 사하구","Mar-19","16","138649","330626","165597","165029","9.5","7915"
"부산광역시 사하구","2018","16","138631","333605","167268","166337","9.5","7964"
"부산광역시 사하구","2018","16","138503","332765","166823","165942","9.5","7967"
"부산광역시 사하구","2018","16","138068","337423","169112","168311","9.6","8055"
"부산광역시 사하구","2018","16","138305","337096","168957","168139","9.6","8047"
"부산광역시 사하구","2018","16","138368","336663","168754","167909","9.6","8037"
"부산광역시 사하구","2018","16","138372","335244","168016","167228","9.6","8003"
"부산광역시 사하구","2017","16","137679","338112","169379","168733","9.6","8071"
"부산광역시 사하구","2018","16","137872","337909","169320","168589","9.6","8067"
"부산광역시 사하구","2018","16","138371","336110","168493","167617","9.6","8024"
"부산광역시 사하구","2018","16","138354","335691","168286","167405","9.6","8014"
"부산광역시 사하구","2018","16","138616","334025","167461","166564","9.5","7974"
"부산광역시 사하구","2017","16","136473","338707","169745","168962","9.6","8113"
"부산광역시 사하구","2017","16","136766","338638","169696","168942","9.6","8111"
"부산광역시 사하구","2017","16","136985","338746","169766","168980","9.6","8114"
"부산광역시 사하구","2017","16","137443","338982","169808","169174","9.6","8119"
"부산광역시 사하구","2017","16","137420","338360","169469","168891","9.6","8104"
"부산광역시 사하구","2017","16","137499","338169","169398","168771","9.6","8099"
"부산광역시 사하구","2017","16","137254","338893","169818","169075","9.6","8117"
"부산광역시 사하구","2017","16","135812","339609","170326","169283","9.6","8134"
"부산광역시 사하구","2017","16","136012","339203","170123","169080","9.6","8125"
"부산광역시 사하구","2017","16","136112","338816","169836","168980","9.6","8115"
"부산광역시 사하구","2017","16","136220","338581","169709","168872","9.6","8110"
"부산광역시 사하구","2013","16","134841","353243","177482","175761","9.91","8467"
"부산광역시 사하구","2014","16","134877","347859","174737","173122","9.78","8332"
"부산광역시 사하구","2015","16","134692","342804","172035","170769","9.6","8211"
"부산광역시 사하구","2016","16","135641","339620","170374","169246","9.6","8135"
"부산광역시 사하구","2017","16","137679","338112","169379","168733","9.6","8071"
"부산광역시 사하구","2007","16","128199","368371","185091","183280","10.19","8998"
"부산광역시 사하구","2008","16","130112","369413","185525","183888","10.27","9023"
"부산광역시 사하구","2009","16","130410","363630","182698","180932","10.17","8882"
"부산광역시 사하구","2010","16","133694","362697","182407","180290","10.07","8855"
"부산광역시 사하구","2011","16","133869","359651","180927","178724","10.03","8621"
"부산광역시 사하구","2012","16","134327","356769","179325","177444","9.98","8552"
"부산광역시 사상구","Oct-22","12","98135","208037","104846","103191","6.2","5763"
"부산광역시 사상구","Nov-22","12","98324","208272","104977","103295","6.2","5769"
"부산광역시 사상구","Dec-22","12","98625","208553","105119","103434","6.2","5777"
"부산광역시 사상구","Jan-23","12","98779","208500","105074","103426","6.2","5776"
"부산광역시 사상구","May-22","12","98702","210605","106220","104385","6.2","5834"
"부산광역시 사상구","Jun-22","12","98741","210294","106072","104222","6.2","5825"
"부산광역시 사상구","Jul-22","12","98690","209771","105780","103991","6.2","5811"
"부산광역시 사상구","Aug-22","12","98694","209199","105492","103707","6.2","5795"
"부산광역시 사상구","Sep-22","12","98256","208630","105155","103475","6.2","5779"
"부산광역시 사상구","Jan-22","12","98536","212177","107160","105017","6.3","5877"
"부산광역시 사상구","Feb-22","12","98603","211432","106793","104639","6.2","5857"
"부산광역시 사상구","Mar-22","12","98651","211304","106596","104708","6.2","5853"
"부산광역시 사상구","Apr-22","12","98618","210863","106360","104503","6.2","5841"
"부산광역시 사상구","Sep-21","12","98505","213940","108100","105840","6.3","5926"
"부산광역시 사상구","Oct-21","12","98616","213685","107961","105724","6.3","5919"
"부산광역시 사상구","Nov-21","12","98627","213290","107732","105558","6.3","5908"
"부산광역시 사상구","Dec-21","12","98621","212771","107440","105331","6.3","5894"
"부산광역시 사상구","May-21","12","98003","215117","108761","106356","6.3","5959"
"부산광역시 사상구","Jun-21","12","98179","214810","108587","106223","6.3","5950"
"부산광역시 사상구","Jul-21","12","98304","214401","108376","106025","6.3","5939"
"부산광역시 사상구","Aug-21","12","98305","213856","108131","105725","6.3","5924"
"부산광역시 사상구","Jan-21","12","97687","216678","109640","107038","6.3","6002"
"부산광역시 사상구","Feb-21","12","97946","216436","109530","106906","6.3","5995"
"부산광역시 사상구","Mar-21","12","97727","215731","109124","106607","6.3","5976"
"부산광역시 사상구","Apr-21","12","97841","215465","108954","106511","6.3","5969"
"부산광역시 사상구","Aug-20","12","97274","219383","111114","108269","6.4","6079"
"부산광역시 사상구","Sep-20","12","97357","218913","110845","108068","6.3","6066"
"부산광역시 사상구","Oct-20","12","97343","218362","110555","107807","6.3","6050"
"부산광역시 사상구","Nov-20","12","97419","217787","110221","107566","6.3","6035"
"부산광역시 사상구","Dec-20","12","97556","217135","109876","107259","6.3","6015"
"부산광역시 사상구","Feb-23","12","99040","208353","104972","103381","6.2","5772"
"부산광역시 사상구","Mar-23","12","99173","208557","104973","103584","6.2","5777"
"부산광역시 사상구","Apr-23","12","99293","208601","104954","103647","6.2","5778"
"부산광역시 사상구","May-23","12","99353","208586","104953","103633","6.2","5778"
"부산광역시 사상구","Mar-20","12","96859","221983","112448","109535","6.4","6151"
"부산광역시 사상구","Apr-20","12","96924","221480","112219","109261","6.4","6137"
"부산광역시 사상구","May-20","12","97038","220861","111907","108954","6.4","6120"
"부산광역시 사상구","Jun-20","12","97113","220468","111722","108746","6.4","6109"
"부산광역시 사상구","Jul-20","12","97215","220011","111480","108531","6.3","6096"
"부산광역시 사상구","Sep-19","12","96926","225751","114243","111508","6.5","6255"
"부산광역시 사상구","Oct-19","12","96868","225046","113914","111132","6.5","6236"
"부산광역시 사상구","Nov-19","12","96780","224455","113607","110848","6.5","6219"
"부산광역시 사상구","Dec-19","12","96726","223489","113217","110272","6.4","6193"
"부산광역시 사상구","Jan-20","12","96652","222840","112913","109927","6.4","6175"
"부산광역시 사상구","Feb-20","12","96781","222476","112720","109756","6.4","6164"
"부산광역시 사상구","Apr-19","12","97021","227635","115331","112304","6.5","6307"
"부산광역시 사상구","May-19","12","97143","227492","115230","112262","6.5","6303"
"부산광역시 사상구","Jun-19","12","97076","226867","114904","111963","6.5","6286"
"부산광역시 사상구","Jul-19","12","97027","226378","114631","111747","6.5","6273"
"부산광역시 사상구","Aug-19","12","96951","225812","114342","111470","6.5","6257"
"부산광역시 사상구","2018","12","96606","230677","117148","113529","6.6","6392"
"부산광역시 사상구","2018","12","96620","230183","116859","113324","6.6","6378"
"부산광역시 사상구","2018","12","96698","229010","116192","112818","6.6","6346"
"부산광역시 사상구","Jan-19","12","96642","228414","115903","112511","6.5","6329"
"부산광역시 사상구","Feb-19","12","96667","227760","115556","112204","6.5","6311"
"부산광역시 사상구","Mar-19","12","96900","228243","115627","112616","6.5","6324"
"부산광역시 사상구","2018","12","96785","230054","116727","113327","6.6","6374"
"부산광역시 사상구","2018","12","96782","229727","116538","113189","6.6","6365"
"부산광역시 사상구","2018","12","97168","233443","118709","114734","6.6","6468"
"부산광역시 사상구","2018","12","97094","233294","118477","114817","6.6","6464"
"부산광역시 사상구","2018","12","96931","232535","118088","114447","6.6","6443"
"부산광역시 사상구","2017","12","97101","234982","119517","115465","6.7","6510"
"부산광역시 사상구","2018","12","97146","234049","119019","115030","6.7","6485"
"부산광역시 사상구","2018","12","96764","231795","117701","114094","6.6","6423"
"부산광역시 사상구","2018","12","96676","231239","117433","113806","6.6","6407"
"부산광역시 사상구","2018","12","96671","230472","116937","113535","6.6","6386"
"부산광역시 사상구","2017","12","96667","236260","120207","116053","6.7","6546"
"부산광역시 사상구","2017","12","96835","235975","120088","115887","6.7","6539"
"부산광역시 사상구","2017","12","97126","236058","120014","116044","6.7","6541"
"부산광역시 사상구","2017","12","97108","235392","119730","115662","6.7","6522"
"부산광역시 사상구","2017","12","97021","235463","119849","115614","6.7","6524"
"부산광역시 사상구","2017","12","97169","234624","119308","115316","6.7","6501"
"부산광역시 사상구","2017","12","96435","237724","121027","116697","6.7","6587"
"부산광역시 사상구","2017","12","96519","237147","120739","116408","6.7","6571"
"부산광역시 사상구","2017","12","97169","234624","119308","115316","6.7","6501"
"부산광역시 사상구","2017","12","96554","237024","120579","116445","6.7","6568"
"부산광역시 사상구","2017","12","96585","236656","120398","116258","6.7","6557"
"부산광역시 사상구","2012","12","96373","254377","130016","124361","7.12","7048"
"부산광역시 사상구","2013","12","96636","251014","128337","122677","7.04","6955"
"부산광역시 사상구","2014","12","96915","247364","126248","121116","6.95","6854"
"부산광역시 사상구","2015","12","96671","242671","123744","118927","6.8","6724"
"부산광역시 사상구","2016","12","96403","238108","121250","116858","6.7","6598"
"부산광역시 사상구","2017","12","96966","235726","119967","115759","6.7","6532"
"부산광역시 사상구","2007","14","93477","268880","137100","131780","7.44","7502"
"부산광역시 사상구","2008","12","93480","264685","135083","129602","7.36","7343"
"부산광역시 사상구","2009","12","93149","258975","132146","126829","7.25","7182"
"부산광역시 사상구","2010","12","96873","261673","133857","127816","7.27","7257"
"부산광역시 사상구","2011","12","96840","258515","132392","126123","7.21","7169"
"부산광역시 북구","Oct-22","13","123831","281871","138758","143113","8.4","7160"
"부산광역시 북구","Nov-22","13","123693","281408","138496","142912","8.4","7148"
"부산광역시 북구","Dec-22","13","123569","280940","138213","142727","8.3","7136"
"부산광역시 북구","Jan-23","13","123569","280662","138026","142636","8.3","7129"
"부산광역시 북구","Jun-22","13","123579","282625","139282","143343","8.4","7179"
"부산광역시 북구","Jul-22","13","123626","282381","139124","143257","8.4","7172"
"부산광역시 북구","Aug-22","13","123788","282230","139034","143196","8.4","7169"
"부산광역시 북구","Sep-22","13","123761","282072","138909","143163","8.4","7165"
"부산광역시 북구","Feb-22","13","123263","283878","139985","143893","8.4","7211"
"부산광역시 북구","Mar-22","13","123286","283300","139680","143620","8.4","7196"
"부산광역시 북구","Apr-22","13","123330","282955","139491","143464","8.4","7187"
"부산광역시 북구","May-22","13","123469","282753","139382","143371","8.4","7182"
"부산광역시 북구","Sep-21","13","122950","286138","141259","144879","8.4","7268"
"부산광역시 북구","Oct-21","13","123090","285961","141185","144776","8.4","7263"
"부산광역시 북구","Nov-21","13","123283","285767","141023","144744","8.4","7258"
"부산광역시 북구","Dec-21","13","123316","285390","140791","144599","8.4","7249"
"부산광역시 북구","Jan-22","13","123247","284705","140402","144303","8.4","7232"
"부산광역시 북구","May-21","13","121596","285389","141065","144324","8.4","7249"
"부산광역시 북구","Jun-21","13","122023","285847","141260","144587","8.4","7261"
"부산광역시 북구","Jul-21","13","122336","285928","141260","144668","8.4","7263"
"부산광역시 북구","Aug-21","13","122676","286121","141315","144806","8.4","7267"
"부산광역시 북구","Jan-21","13","120728","285787","141324","144463","8.3","7259"
"부산광역시 북구","Feb-21","13","120741","285105","140890","144215","8.3","7242"
"부산광역시 북구","Mar-21","13","120370","284127","140402","143725","8.3","7217"
"부산광역시 북구","Apr-21","13","120807","284334","140532","143802","8.3","7222"
"부산광역시 북구","Sep-20","13","120703","288689","142787","145902","8.4","7333"
"부산광역시 북구","Oct-20","13","120604","287867","142378","145489","8.4","7312"
"부산광역시 북구","Nov-20","13","120665","287203","142052","145151","8.3","7295"
"부산광역시 북구","Dec-20","13","120668","286291","141605","144686","8.3","7272"
"부산광역시 북구","Feb-23","13","123568","280121","137747","142374","8.3","7115"
"부산광역시 북구","Mar-23","13","123573","279814","137586","142228","8.3","7107"
"부산광역시 북구","Apr-23","13","123532","279440","137379","142061","8.3","7098"
"부산광역시 북구","May-23","13","123510","279074","137171","141903","8.3","7088"
"부산광역시 북구","Mar-20","13","120496","292106","144564","147542","8.4","7420"
"부산광역시 북구","Apr-20","13","120449","291527","144265","147262","8.4","7405"
"부산광역시 북구","May-20","13","120663","291433","144186","147247","8.4","7402"
"부산광역시 북구","Jun-20","13","120694","290808","143863","146945","8.4","7387"
"부산광역시 북구","Jul-20","13","120706","290157","143561","146596","8.4","7370"
"부산광역시 북구","Aug-20","13","120652","289260","143072","146188","8.4","7347"
"부산광역시 북구","Oct-19","13","119668","293714","145517","148197","8.5","7460"
"부산광역시 북구","Nov-19","13","120061","293926","145587","148339","8.5","7466"
"부산광역시 북구","Dec-19","13","120273","293704","145449","148255","8.5","7460"
"부산광역시 북구","Jan-20","13","120406","293482","145311","148171","8.5","7454"
"부산광역시 북구","Feb-20","13","120435","292797","144945","147852","8.5","7437"
"부산광역시 북구","Apr-19","13","119722","296583","147017","149566","8.5","7533"
"부산광역시 북구","May-19","13","119648","295949","146665","149284","8.5","7517"
"부산광역시 북구","Jun-19","13","119611","295468","146459","149009","8.5","7505"
"부산광역시 북구","Jul-19","13","119591","294990","146170","148820","8.5","7493"
"부산광역시 북구","Aug-19","13","119537","294374","145875","148499","8.5","7477"
"부산광역시 북구","Sep-19","13","119578","294030","145690","148340","8.5","7468"
"부산광역시 북구","2018","13","120079","301476","149453","152023","8.6","7658"
"부산광역시 북구","2018","13","120128","301183","149311","151872","8.6","7650"
"부산광역시 북구","Jan-19","13","119970","298884","148156","150728","8.6","7592"
"부산광역시 북구","Feb-19","13","119906","298093","147827","150266","8.5","7572"
"부산광역시 북구","Mar-19","13","119828","297280","147376","149904","8.5","7551"
"부산광역시 북구","2018","13","120087","300051","148754","151297","8.6","7621"
"부산광역시 북구","2018","13","120036","299547","148471","151076","8.6","7609"
"부산광역시 북구","2018","13","120178","303955","150724","153231","8.6","7720"
"부산광역시 북구","2018","13","120142","303468","150483","152985","8.6","7708"
"부산광역시 북구","2018","13","120123","303031","150206","152825","8.6","7697"
"부산광역시 북구","2017","13","120249","305045","151255","153790","8.7","7748"
"부산광역시 북구","2018","13","120227","304579","151032","153547","8.7","7736"
"부산광역시 북구","2018","13","120194","302677","150034","152643","8.6","7688"
"부산광역시 북구","2018","13","120175","302356","149887","152469","8.6","7680"
"부산광역시 북구","2018","13","120124","302047","149743","152304","8.6","7672"
"부산광역시 북구","2018","13","120146","300674","149082","151592","8.6","7637"
"부산광역시 북구","2017","13","120870","310207","153912","156295","8.8","7881"
"부산광역시 북구","2017","13","120823","309598","153591","156007","8.8","7866"
"부산광역시 북구","2017","13","120818","308828","153211","155617","8.7","7846"
"부산광역시 북구","2017","13","120647","307410","152391","155019","8.7","7810"
"부산광역시 북구","2017","13","120468","306439","151933","154506","8.7","7785"
"부산광역시 북구","2017","13","120346","305740","151578","154162","8.7","7767"
"부산광역시 북구","2017","13","120701","307947","152739","155208","8.7","7824"
"부산광역시 북구","2017","13","120704","311743","154898","156845","8.8","7920"
"부산광역시 북구","2017","13","120791","311065","154528","156537","8.8","7903"
"부산광역시 북구","2017","13","120875","310817","154312","156505","8.8","7897"
"부산광역시 북구","2017","13","120909","310709","154168","156541","8.8","7894"
"부산광역시 북구","2013","13","115308","310880","154864","156016","8.72","7898"
"부산광역시 북구","2014","13","115869","308215","153314","154901","8.66","7831"
"부산광역시 북구","2015","13","118865","312016","155065","156951","8.8","7927"
"부산광역시 북구","2016","13","120707","312098","155080","157018","8.8","7929"
"부산광역시 북구","2017","13","120249","305045","151255","153790","8.7","7748"
"부산광역시 북구","2007","13","111384","326602","163189","163413","9.03","8527"
"부산광역시 북구","2008","13","110550","320328","159860","160468","8.91","8123"
"부산광역시 북구","2009","13","110502","315606","157379","158227","8.83","8002"
"부산광역시 북구","2010","13","112634","313553","156598","156955","8.71","7950"
"부산광역시 북구","2011","13","112592","309239","154284","154955","8.62","7857"
"부산광역시 북구","2012","13","115306","314085","156608","157477","8.79","7980"
"부산광역시 부산진구","Oct-22","20","176765","356251","171164","185087","10.6","12007"
"부산광역시 부산진구","Nov-22","20","177576","358021","171996","186025","10.6","12067"
"부산광역시 부산진구","Dec-22","20","178049","358644","172214","186430","10.7","12088"
"부산광역시 부산진구","Jan-23","20","178397","359061","172381","186680","10.7","12102"
"부산광역시 부산진구","Jun-22","20","174624","353674","169982","183692","10.5","11920"
"부산광역시 부산진구","Jul-22","20","175150","354120","170222","183898","10.5","11935"
"부산광역시 부산진구","Aug-22","20","175696","354367","170267","184100","10.5","11944"
"부산광역시 부산진구","Sep-22","20","175448","353819","169947","183872","10.5","11925"
"부산광역시 부산진구","Feb-22","20","173496","354445","170555","183890","10.4","11946"
"부산광역시 부산진구","Mar-22","20","173573","353840","170248","183592","10.4","11926"
"부산광역시 부산진구","Apr-22","20","173947","353687","170112","183575","10.4","11921"
"부산광역시 부산진구","May-22","20","174306","353659","169997","183662","10.4","11920"
"부산광역시 부산진구","Oct-21","20","173300","357200","171877","185323","10.5","12039"
"부산광역시 부산진구","Nov-21","20","173278","356546","171585","184961","10.5","12017"
"부산광역시 부산진구","Dec-21","20","173353","355902","171262","184640","10.5","11995"
"부산광역시 부산진구","Jan-22","20","173327","355187","170949","184238","10.5","11971"
"부산광역시 부산진구","May-21","20","172912","359504","173351","186153","10.5","12117"
"부산광역시 부산진구","Jun-21","20","172864","358896","173049","185847","10.5","12096"
"부산광역시 부산진구","Jul-21","20","172962","358333","172745","185588","10.5","12077"
"부산광역시 부산진구","Aug-21","20","173084","357872","172349","185523","10.5","12062"
"부산광역시 부산진구","Sep-21","20","173279","357670","172161","185509","10.5","12055"
"부산광역시 부산진구","Jan-21","20","173746","362772","174998","187774","10.6","12227"
"부산광역시 부산진구","Feb-21","20","174327","362796","174884","187912","10.6","12228"
"부산광역시 부산진구","Mar-21","20","172683","360491","173860","186631","10.5","12150"
"부산광역시 부산진구","Apr-21","20","172771","360021","173641","186380","10.5","12134"
"부산광역시 부산진구","Sep-20","20","171008","360431","173987","186444","10.5","12148"
"부산광역시 부산진구","Oct-20","20","171637","361172","174403","186769","10.5","12173"
"부산광역시 부산진구","Nov-20","20","172561","362213","174861","187352","10.5","12208"
"부산광역시 부산진구","Dec-20","20","173263","362701","175064","187637","10.5","12225"
"부산광역시 부산진구","Feb-23","20","179307","360045","172765","187280","10.7","12135"
"부산광역시 부산진구","Mar-23","20","179744","360354","172892","187462","10.7","12145"
"부산광역시 부산진구","Apr-23","20","179949","360365","172886","187479","10.7","12146"
"부산광역시 부산진구","May-23","20","180263","360565","172971","187594","10.7","12153"
"부산광역시 부산진구","Mar-20","20","167761","359790","173899","185891","10.4","12126"
"부산광역시 부산진구","Apr-20","20","168189","359968","173926","186042","10.4","12132"
"부산광역시 부산진구","May-20","20","168789","360102","173984","186118","10.4","12137"
"부산광역시 부산진구","Jun-20","20","169203","360176","173950","186226","10.4","12139"
"부산광역시 부산진구","Jul-20","20","169952","360582","174125","186457","10.4","12153"
"부산광역시 부산진구","Aug-20","20","170624","360634","174170","186464","10.5","12155"
"부산광역시 부산진구","Oct-19","20","166539","361927","175238","186689","10.4","12198"
"부산광역시 부산진구","Nov-19","20","166660","361542","175017","186525","10.4","12185"
"부산광역시 부산진구","Dec-19","20","166865","361044","174721","186323","10.4","12169"
"부산광역시 부산진구","Jan-20","20","166981","360439","174373","186066","10.4","12148"
"부산광역시 부산진구","Feb-20","20","167266","359945","174090","185855","10.4","12132"
"부산광역시 부산진구","Apr-19","20","165173","362312","175733","186579","10.4","12211"
"부산광역시 부산진구","May-19","20","165287","361869","175487","186382","10.4","12196"
"부산광역시 부산진구","Jun-19","20","165576","361909","175500","186409","10.4","12198"
"부산광역시 부산진구","Jul-19","20","165842","361953","175440","186513","10.4","12199"
"부산광역시 부산진구","Aug-19","20","166174","362128","175470","186658","10.4","12205"
"부산광역시 부산진구","Sep-19","20","166434","362296","175453","186843","10.4","12211"
"부산광역시 부산진구","2018","20","165751","368516","179305","189211","10.5","12420"
"부산광역시 부산진구","2018","20","165737","368161","179092","189069","10.5","12409"
"부산광역시 부산진구","Jan-19","20","165151","364551","177159","187392","10.4","12287"
"부산광역시 부산진구","Feb-19","20","165252","363871","176657","187214","10.4","12264"
"부산광역시 부산진구","Mar-19","20","165268","363231","176241","186990","10.4","12242"
"부산광역시 부산진구","2018","20","165406","366244","178006","188238","10.5","12344"
"부산광역시 부산진구","2018","20","165253","365337","177512","187825","10.5","12313"
"부산광역시 부산진구","2018","20","166427","372362","181325","191037","10.6","12550"
"부산광역시 부산진구","2018","20","166423","371721","180953","190768","10.6","12529"
"부산광역시 부산진구","2018","20","166304","371134","180667","190467","10.6","12509"
"부산광역시 부산진구","2017","20","166491","374504","182588","191916","10.6","12622"
"부산광역시 부산진구","2018","20","166392","373712","182189","191523","10.6","12596"
"부산광역시 부산진구","2018","20","166375","372922","181716","191206","10.6","12569"
"부산광역시 부산진구","2018","20","166084","370440","180298","190142","10.6","12485"
"부산광역시 부산진구","2018","20","165853","369413","179745","189668","10.5","12451"
"부산광역시 부산진구","2018","20","165643","367219","178522","188697","10.5","12377"
"부산광역시 부산진구","2017","20","166222","378188","184590","193598","10.7","12742"
"부산광역시 부산진구","2017","20","166284","377815","184400","193415","10.7","12730"
"부산광역시 부산진구","2017","20","166738","377843","184408","193435","10.7","12731"
"부산광역시 부산진구","2017","20","166979","377191","183928","193263","10.7","12709"
"부산광역시 부산진구","2017","20","166805","376286","183485","192801","10.7","12677"
"부산광역시 부산진구","2017","20","166594","375358","183030","192328","10.7","12646"
"부산광역시 부산진구","2017","20","166981","377670","184263","193407","10.7","12725"
"부산광역시 부산진구","2017","20","165261","378743","184961","193782","10.7","12761"
"부산광역시 부산진구","2017","20","165316","377973","184540","193433","10.7","12735"
"부산광역시 부산진구","2017","20","165596","377999","184471","193528","10.7","12736"
"부산광역시 부산진구","2017","20","165959","378312","184680","193632","10.7","12746"
"부산광역시 부산진구","2013","23","162795","391957","192656","199301","11","13202"
"부산광역시 부산진구","2014","23","165056","389558","190949","198609","10.95","13116"
"부산광역시 부산진구","2015","21","165199","384274","188061","196213","10.8","12939"
"부산광역시 부산진구","2016","20","165238","379309","185245","194064","10.7","12780"
"부산광역시 부산진구","2017","20","166491","374504","182588","191916","10.6","12622"
"부산광역시 부산진구","2007","25","151256","404331","200609","203722","11.18","13623"
"부산광역시 부산진구","2008","25","152942","402942","199531","203411","11.21","13573"
"부산광역시 부산진구","2009","25","153413","398101","196892","201209","11.14","13409"
"부산광역시 부산진구","2010","25","158253","398174","196864","201310","11.06","13411"
"부산광역시 부산진구","2011","25","159915","397411","196205","201206","11.08","13385"
"부산광역시 부산진구","2012","25","160699","395032","194777","200255","11.05","13305"
"부산광역시 동래구","Oct-22","13","119629","274992","133065","141927","8.2","16536"
"부산광역시 동래구","Nov-22","13","119508","274660","132883","141777","8.2","16516"
"부산광역시 동래구","Dec-22","13","119503","274445","132739","141706","8.2","16503"
"부산광역시 동래구","Jan-23","13","119557","274400","132696","141704","8.2","16500"
"부산광역시 동래구","Jun-22","13","119772","275668","133524","142144","8.1","16577"
"부산광역시 동래구","Jul-22","13","120011","275956","133663","142293","8.2","16594"
"부산광역시 동래구","Aug-22","13","119984","275830","133543","142287","8.2","16586"
"부산광역시 동래구","Sep-22","13","119696","275354","133287","142067","8.2","16558"
"부산광역시 동래구","Feb-22","13","118748","274961","133387","141574","8.1","16534"
"부산광역시 동래구","Mar-22","13","119112","275297","133522","141775","8.1","16554"
"부산광역시 동래구","Apr-22","13","119227","275134","133411","141723","8.1","16544"
"부산광역시 동래구","May-22","13","119446","275173","133310","141863","8.1","16547"
"부산광역시 동래구","Oct-21","13","115301","268074","130178","137896","7.9","16120"
"부산광역시 동래구","Nov-21","13","115310","267705","129977","137728","7.9","16098"
"부산광역시 동래구","Dec-21","13","115718","268004","130093","137911","7.9","16116"
"부산광역시 동래구","Jan-22","13","117211","271480","131810","139670","8","16325"
"부산광역시 동래구","May-21","13","115078","269829","131102","138727","7.9","16225"
"부산광역시 동래구","Jun-21","13","115173","269590","130971","138619","7.9","16211"
"부산광역시 동래구","Jul-21","13","115239","269171","130761","138410","7.9","16186"
"부산광역시 동래구","Aug-21","13","115276","268834","130575","138259","7.9","16166"
"부산광역시 동래구","Sep-21","13","115356","268587","130446","138141","7.9","16151"
"부산광역시 동래구","Jan-21","13","115221","271917","132126","139791","7.9","16351"
"부산광역시 동래구","Feb-21","13","115476","271884","132133","139751","7.9","16349"
"부산광역시 동래구","Mar-21","13","114936","270706","131639","139067","7.9","16278"
"부산광역시 동래구","Apr-21","13","114977","270221","131322","138899","7.9","16249"
"부산광역시 동래구","Sep-20","13","114679","273215","132886","140329","7.9","16429"
"부산광역시 동래구","Oct-20","13","114739","272863","132690","140173","7.9","16408"
"부산광역시 동래구","Nov-20","13","114826","272403","132444","139959","7.9","16380"
"부산광역시 동래구","Dec-20","13","114987","271966","132164","139802","7.9","16354"
"부산광역시 동래구","Feb-23","13","119887","274567","132730","141837","8.2","16510"
"부산광역시 동래구","Mar-23","13","119963","274419","132596","141823","8.2","16501"
"부산광역시 동래구","Apr-23","13","119980","274273","132498","141775","8.2","16493"
"부산광역시 동래구","May-23","13","120032","274065","132445","141620","8.2","16480"
"부산광역시 동래구","Mar-20","13","113266","273573","133179","140394","7.9","16451"
"부산광역시 동래구","Apr-20","13","113547","273819","133324","140495","7.9","16465"
"부산광역시 동래구","May-20","13","113823","273785","133313","140472","7.9","16463"
"부산광역시 동래구","Jun-20","13","114058","273713","133195","140518","7.9","16459"
"부산광역시 동래구","Jul-20","13","114414","273793","133256","140537","7.9","16464"
"부산광역시 동래구","Aug-20","13","114527","273413","132982","140431","7.9","16441"
"부산광역시 동래구","Oct-19","13","111625","271821","132444","139377","7.8","16345"
"부산광역시 동래구","Nov-19","13","111867","272169","132577","139592","7.8","16366"
"부산광역시 동래구","Dec-19","13","112136","272500","132722","139778","7.9","16386"
"부산광역시 동래구","Jan-20","13","112473","272820","132832","139988","7.9","16405"
"부산광역시 동래구","Feb-20","13","112724","272785","132783","140002","7.9","16403"
"부산광역시 동래구","Apr-19","13","109660","268778","131189","137589","7.7","16162"
"부산광역시 동래구","May-19","13","109791","268792","131143","137649","7.7","16163"
"부산광역시 동래구","Jun-19","13","109983","269024","131168","137856","7.7","16177"
"부산광역시 동래구","Jul-19","13","110264","269324","131288","138036","7.7","16195"
"부산광역시 동래구","Aug-19","13","110745","270202","131699","138503","7.8","16248"
"부산광역시 동래구","Sep-19","13","111162","271004","132109","138895","7.8","16296"
"부산광역시 동래구","2018","13","109177","270355","132204","138151","7.7","16257"
"부산광역시 동래구","2018","13","109181","269938","131950","137988","7.7","16232"
"부산광역시 동래구","Jan-19","13","108803","267721","130738","136983","7.7","16099"
"부산광역시 동래구","Feb-19","13","109051","268074","130922","137152","7.7","16120"
"부산광역시 동래구","Mar-19","13","109355","268451","131062","137389","7.7","16143"
"부산광역시 동래구","2018","13","108937","268628","131316","137312","7.7","16153"
"부산광역시 동래구","2018","13","108757","267735","130789","136946","7.7","16100"
"부산광역시 동래구","2018","13","108729","271350","132850","138500","7.7","16317"
"부산광역시 동래구","2018","13","108786","271042","132704","138338","7.7","16298"
"부산광역시 동래구","2018","13","108922","270983","132653","138330","7.7","16295"
"부산광역시 동래구","2017","13","108609","271967","133173","138794","7.7","16354"
"부산광역시 동래구","2018","13","108560","271448","132910","138538","7.7","16323"
"부산광역시 동래구","2018","13","108953","270842","132535","138307","7.7","16286"
"부산광역시 동래구","2018","13","109040","270809","132497","138312","7.7","16284"
"부산광역시 동래구","2018","13","109127","270558","132321","138237","7.7","16269"
"부산광역시 동래구","2018","13","108989","269149","131575","137574","7.7","16185"
"부산광역시 동래구","2017","13","108991","275422","134954","140468","7.8","16562"
"부산광역시 동래구","2017","13","108955","275103","134783","140320","7.8","16543"
"부산광역시 동래구","2017","13","108935","274583","134533","140050","7.8","16511"
"부산광역시 동래구","2017","13","108827","273670","134007","139663","7.7","16456"
"부산광역시 동래구","2017","13","108744","273082","133759","139323","7.7","16417"
"부산광역시 동래구","2017","13","108649","272480","133415","139065","7.7","16381"
"부산광역시 동래구","2017","13","108916","274160","134285","139875","7.8","16486"
"부산광역시 동래구","2017","13","108179","274586","134648","139938","7.7","16511"
"부산광역시 동래구","2017","13","108727","275857","135249","140608","7.8","16588"
"부산광역시 동래구","2017","13","108889","275794","135153","140641","7.8","16584"
"부산광역시 동래구","2017","13","108609","271967","133173","138794","7.7","16354"
"부산광역시 동래구","2017","13","108994","275714","135112","140602","7.8","16579"
"부산광역시 동래구","2012","13","105187","279805","138212","141593","7.83","16825"
"부산광역시 동래구","2013","13","105836","277596","136879","140717","7.79","16692"
"부산광역시 동래구","2014","13","107023","276823","136234","140589","7.78","16646"
"부산광역시 동래구","2015","13","106766","273993","134675","139318","7.7","16476"
"부산광역시 동래구","2016","13","107917","273939","134367","139572","7.7","16473"
"부산광역시 동래구","2007","14","99954","285789","141925","143864","7.91","17175"
"부산광역시 동래구","2008","14","100394","283603","140810","142793","7.89","17037"
"부산광역시 동래구","2009","14","101419","282525","139952","142573","7.9","16968"
"부산광역시 동래구","2010","14","104637","283636","140337","143299","7.88","17056"
"부산광역시 동래구","2011","13","106244","284649","140740","143909","7.94","17117"
"부산광역시 동구","Oct-22","12","46535","89030","43518","45512","2.6","9020"
"부산광역시 동구","Nov-22","12","46402","88773","43399","45374","2.6","8994"
"부산광역시 동구","Dec-22","12","46349","88601","43284","45317","2.6","8977"
"부산광역시 동구","Jan-23","12","46322","88513","43250","45263","2.6","8968"
"부산광역시 동구","Jun-22","12","47052","90186","44022","46164","2.7","9137"
"부산광역시 동구","Jul-22","12","46982","89944","43898","46046","2.7","9113"
"부산광역시 동구","Aug-22","12","47011","89800","43830","45970","2.7","9098"
"부산광역시 동구","Sep-22","12","46553","89213","43618","45595","2.6","9039"
"부산광역시 동구","Feb-22","12","46829","90283","44108","46175","2.7","9147"
"부산광역시 동구","Mar-22","12","46938","90335","44135","46200","2.7","9152"
"부산광역시 동구","Apr-22","12","46970","90308","44092","46216","2.7","9150"
"부산광역시 동구","May-22","12","47024","90296","44068","46228","2.7","9149"
"부산광역시 동구","Oct-21","12","46123","89731","43886","45845","2.6","9101"
"부산광역시 동구","Nov-21","12","46243","89798","43923","45875","2.6","9107"
"부산광역시 동구","Dec-21","12","46362","89712","43851","45861","2.6","9089"
"부산광역시 동구","Jan-22","12","46597","89950","43953","45997","2.6","9113"
"부산광역시 동구","Jun-21","12","45911","89982","43987","45995","2.6","9126"
"부산광역시 동구","Jul-21","12","45930","89813","43881","45932","2.6","9109"
"부산광역시 동구","Aug-21","12","45914","89602","43777","45825","2.6","9087"
"부산광역시 동구","Sep-21","12","46046","89617","43822","45795","2.6","9089"
"부산광역시 동구","Jan-21","12","46081","90905","44464","46441","2.6","9220"
"부산광역시 동구","Feb-21","12","46128","90744","44354","46390","2.6","9203"
"부산광역시 동구","Mar-21","12","45786","90330","44204","46126","2.6","9161"
"부산광역시 동구","Apr-21","12","45865","90257","44159","46098","2.6","9154"
"부산광역시 동구","May-21","12","45918","90136","44063","46073","2.6","9142"
"부산광역시 동구","Sep-20","12","45985","91639","44889","46750","2.7","9285"
"부산광역시 동구","Oct-20","12","45994","91409","44735","46674","2.7","9261"
"부산광역시 동구","Nov-20","12","46003","91194","44619","46575","2.6","9240"
"부산광역시 동구","Dec-20","12","46003","91061","44528","46533","2.6","9235"
"부산광역시 동구","Feb-23","12","46224","88151","43021","45130","2.6","8931"
"부산광역시 동구","Mar-23","12","46196","88013","42926","45087","2.6","8917"
"부산광역시 동구","Apr-23","12","46162","87818","42819","44999","2.6","8897"
"부산광역시 동구","May-23","12","46152","87744","42757","44987","2.6","8890"
"부산광역시 동구","Mar-20","12","45356","91585","44918","46667","2.6","9279"
"부산광역시 동구","Apr-20","12","45578","91994","45109","46885","2.7","9321"
"부산광역시 동구","May-20","12","45755","91996","45089","46907","2.7","9321"
"부산광역시 동구","Jun-20","12","45873","91975","45080","46895","2.7","9319"
"부산광역시 동구","Jul-20","12","45954","91979","45092","46887","2.6","9319"
"부산광역시 동구","Aug-20","12","45994","91907","45015","46892","2.7","9312"
"부산광역시 동구","Oct-19","12","44328","90111","44303","45808","2.6","9252"
"부산광역시 동구","Nov-19","12","44473","90245","44350","45895","2.6","9265"
"부산광역시 동구","Dec-19","12","44657","90477","44416","46061","2.6","9167"
"부산광역시 동구","Jan-20","12","44734","90632","44480","46152","2.6","9183"
"부산광역시 동구","Feb-20","12","44894","90778","44557","46221","2.6","9197"
"부산광역시 동구","May-19","12","43356","88547","43590","44957","2.5","9091"
"부산광역시 동구","Jun-19","12","43337","88411","43492","44919","2.5","9077"
"부산광역시 동구","Jul-19","12","43379","88361","43500","44861","2.5","9072"
"부산광역시 동구","Aug-19","12","43784","89171","43875","45296","2.6","9155"
"부산광역시 동구","Sep-19","12","44075","89692","44103","45589","2.6","9209"
"부산광역시 동구","2018","12","43222","89422","44057","45365","2.6","9181"
"부산광역시 동구","2018","12","43247","89392","44015","45377","2.6","9178"
"부산광역시 동구","Jan-19","12","43314","89070","43853","45217","2.6","9145"
"부산광역시 동구","Feb-19","12","43309","88893","43753","45140","2.5","9127"
"부산광역시 동구","Mar-19","12","43306","88825","43727","45098","2.5","9120"
"부산광역시 동구","Apr-19","12","43319","88710","43681","45029","2.5","9108"
"부산광역시 동구","2018","12","43272","89177","43903","45274","2.6","9156"
"부산광역시 동구","2018","12","43261","89144","43868","45276","2.6","9152"
"부산광역시 동구","2018","12","43427","90389","44521","45868","2.6","9280"
"부산광역시 동구","2018","12","43386","90230","44421","45809","2.6","9264"
"부산광역시 동구","2018","12","43347","90031","44330","45701","2.6","9243"
"부산광역시 동구","2017","12","43413","90856","44786","46070","2.6","9328"
"부산광역시 동구","2018","12","43443","90808","44754","46054","2.6","9323"
"부산광역시 동구","2018","12","43460","90668","44669","45999","2.6","9309"
"부산광역시 동구","2018","12","43326","89842","44265","45577","2.6","9224"
"부산광역시 동구","2018","12","43239","89542","44105","45437","2.6","9193"
"부산광역시 동구","2018","12","43287","89253","43942","45311","2.6","9164"
"부산광역시 동구","2017","12","43093","91053","44974","46079","2.6","9348"
"부산광역시 동구","2017","12","43078","90905","44900","46005","2.6","9333"
"부산광역시 동구","2017","12","43100","90766","44777","45989","2.6","9319"
"부산광역시 동구","2017","12","43311","91078","44888","46190","2.6","9351"
"부산광역시 동구","2017","12","43393","91069","44882","46187","2.6","9353"
"부산광역시 동구","2017","12","43427","91067","44889","46178","2.6","9353"
"부산광역시 동구","2017","12","43203","90976","44846","46130","2.6","9340"
"부산광역시 동구","2017","12","43088","91691","45319","46372","2.6","9414"
"부산광역시 동구","2017","12","43155","91570","45245","46325","2.6","9401"
"부산광역시 동구","2017","12","43159","91474","45193","46281","2.6","9392"
"부산광역시 동구","2017","12","43110","91229","45036","46193","2.6","9366"
"부산광역시 동구","2013","14","43528","97450","48355","49095","2.73","10015"
"부산광역시 동구","2014","14","43728","96017","47523","48494","2.7","9868"
"부산광역시 동구","2015","13","43430","93877","46403","47474","2.6","9638"
"부산광역시 동구","2016","12","43036","91807","45377","46430","2.6","9426"
"부산광역시 동구","2017","12","43413","90856","44786","46070","2.6","9328"
"부산광역시 동구","2007","17","42202","105970","52942","53028","2.93","10835"
"부산광역시 동구","2008","14","42197","103983","51995","51988","2.89","10634"
"부산광역시 동구","2009","14","42297","102440","51141","51299","2.87","10474"
"부산광역시 동구","2010","14","44018","102859","51209","51650","2.86","10517"
"부산광역시 동구","2011","14","44192","101845","50662","51183","2.84","10467"
"부산광역시 동구","2012","14","43859","99907","49576","50331","2.8","10268"
"부산광역시 남구","Oct-22","17","117964","262904","128458","134446","7.8","9803"
"부산광역시 남구","Nov-22","17","117707","262584","128355","134229","7.8","9791"
"부산광역시 남구","Dec-22","17","117601","262253","128182","134071","7.8","9778"
"부산광역시 남구","Jan-23","17","117668","262093","128079","134014","7.8","9772"
"부산광역시 남구","Jun-22","17","118480","265158","129581","135577","7.8","9887"
"부산광역시 남구","Jul-22","17","118358","264557","129277","135280","7.8","9864"
"부산광역시 남구","Aug-22","17","118468","264112","129045","135067","7.8","9848"
"부산광역시 남구","Sep-22","17","118179","263401","128694","134707","7.8","9821"
"부산광역시 남구","Feb-22","17","117815","265905","129966","135939","7.8","9914"
"부산광역시 남구","Mar-22","17","118153","266025","130008","136017","7.8","9919"
"부산광역시 남구","Apr-22","17","118406","266059","130045","136014","7.9","9920"
"부산광역시 남구","May-22","17","118544","265675","129842","135833","7.8","9906"
"부산광역시 남구","Oct-21","17","118005","268663","131343","137320","7.9","10017"
"부산광역시 남구","Nov-21","17","117987","268246","131125","137121","7.9","10002"
"부산광역시 남구","Dec-21","17","117821","267422","130654","136768","7.9","9971"
"부산광역시 남구","Jan-22","17","117619","266557","130274","136283","7.9","9939"
"부산광역시 남구","May-21","17","117429","270063","132274","137789","7.9","10069"
"부산광역시 남구","Jun-21","17","117410","269492","131951","137541","7.9","10048"
"부산광역시 남구","Jul-21","17","117384","269085","131692","137393","7.9","10033"
"부산광역시 남구","Aug-21","17","117494","268615","131412","137203","7.9","10015"
"부산광역시 남구","Sep-21","17","117793","268683","131395","137288","7.9","10018"
"부산광역시 남구","Jan-21","17","117885","272700","133507","139193","7.9","10168"
"부산광역시 남구","Feb-21","17","118052","272272","133311","138961","7.9","10152"
"부산광역시 남구","Mar-21","17","117391","271176","132814","138362","7.9","10111"
"부산광역시 남구","Apr-21","17","117426","270610","132538","138072","7.9","10090"
"부산광역시 남구","Sep-20","17","117696","274824","134572","140252","8","10247"
"부산광역시 남구","Oct-20","17","117685","274232","134335","139897","8","10225"
"부산광역시 남구","Nov-20","17","117804","273735","134096","139639","8","10206"
"부산광역시 남구","Dec-20","17","117876","273144","133785","139359","7.9","10184"
"부산광역시 남구","Feb-23","17","118209","262157","128132","134025","7.8","9775"
"부산광역시 남구","Mar-23","17","118462","262385","128209","134176","7.8","9783"
"부산광역시 남구","Apr-23","17","118556","262382","128177","134205","7.8","9783"
"부산광역시 남구","May-23","17","118686","262272","128089","134183","7.8","9779"
"부산광역시 남구","Mar-20","17","117299","278619","136448","142171","8","10388"
"부산광역시 남구","Apr-20","17","117167","277599","136018","141581","8","10350"
"부산광역시 남구","May-20","17","117350","276728","135553","141175","8","10318"
"부산광역시 남구","Jun-20","17","117429","276111","135244","140867","8","10295"
"부산광역시 남구","Jul-20","17","117537","275565","134988","140577","7.9","10275"
"부산광역시 남구","Aug-20","17","117649","274994","134693","140301","8","10253"
"부산광역시 남구","Oct-19","17","117773","282281","138441","143840","8.1","10529"
"부산광역시 남구","Nov-19","17","117518","281507","138038","143469","8.1","10500"
"부산광역시 남구","Dec-19","17","117397","280852","137667","143185","8.1","10472"
"부산광역시 남구","Jan-20","17","117212","280052","137258","142794","8.1","10442"
"부산광역시 남구","Feb-20","17","117208","279203","136804","142399","8.1","10410"
"부산광역시 남구","Apr-19","17","117969","284870","139822","145048","8.2","10626"
"부산광역시 남구","May-19","17","118283","284946","139826","145120","8.2","10628"
"부산광역시 남구","Jun-19","17","118282","284626","139649","144977","8.2","10616"
"부산광역시 남구","Jul-19","17","118197","284122","139351","144771","8.2","10598"
"부산광역시 남구","Aug-19","17","118112","283444","139053","144391","8.2","10572"
"부산광역시 남구","Sep-19","17","118024","283267","138888","144379","8.2","10566"
"부산광역시 남구","2018","17","116684","285220","140198","145022","8.1","10639"
"부산광역시 남구","2018","17","117033","286038","140533","145505","8.2","10669"
"부산광역시 남구","Jan-19","17","117559","285758","140302","145456","8.2","10659"
"부산광역시 남구","Feb-19","17","117743","285228","140115","145113","8.2","10639"
"부산광역시 남구","Mar-19","17","117873","285083","139979","145104","8.2","10633"
"부산광역시 남구","2018","17","117536","286502","140687","145815","8.2","10686"
"부산광역시 남구","2018","17","117558","286093","140516","145577","8.2","10671"
"부산광역시 남구","2018","17","113952","278681","136937","141744","7.9","10395"
"부산광역시 남구","2018","17","114663","280739","137817","142922","8","10471"
"부산광역시 남구","2018","17","115129","281855","138464","143391","8","10513"
"부산광역시 남구","2017","17","113898","279309","137236","142073","7.9","10418"
"부산광역시 남구","2018","17","113755","278717","136933","141784","7.9","10396"
"부산광역시 남구","2018","17","115491","282774","138930","143844","8.1","10547"
"부산광역시 남구","2018","17","115729","283384","139248","144136","8.1","10570"
"부산광역시 남구","2018","17","116233","284518","139826","144692","8.1","10612"
"부산광역시 남구","2018","17","117412","286483","140736","145747","8.2","10686"
"부산광역시 남구","2017","17","113733","281163","138028","143135","7.9","10487"
"부산광역시 남구","2017","17","113773","280939","137938","143001","7.9","10479"
"부산광역시 남구","2017","17","113934","280863","137939","142924","7.9","10476"
"부산광역시 남구","2017","17","113973","280674","137817","142857","7.9","10469"
"부산광역시 남구","2017","17","113946","280088","137594","142494","7.9","10447"
"부산광역시 남구","2017","17","113925","279700","137396","142304","7.9","10433"
"부산광역시 남구","2017","17","113950","280296","137608","142688","7.9","10455"
"부산광역시 남구","2017","17","113755","282700","138851","143849","8","10545"
"부산광역시 남구","2017","17","113789","282173","138592","143581","8","10525"
"부산광역시 남구","2017","17","113785","282083","138435","143648","8","10522"
"부산광역시 남구","2017","17","113701","281487","138165","143322","8","10499"
"부산광역시 남구","2013","17","114945","295195","145755","149440","8.28","11011"
"부산광역시 남구","2014","17","114412","290137","142993","147144","8.16","10822"
"부산광역시 남구","2015","17","114120","286940","141177","145763","8.1","10703"
"부산광역시 남구","2016","17","113791","283070","139047","144023","8","10558"
"부산광역시 남구","2017","17","113898","279309","137236","142073","7.9","10418"
"부산광역시 남구","2007","19","107476","298898","149119","149779","8.27","11300"
"부산광역시 남구","2008","19","109472","300966","149964","151002","8.37","11370"
"부산광역시 남구","2009","19","110473","301043","149648","151395","8.42","11309"
"부산광역시 남구","2010","19","113426","301904","149905","151999","8.39","11278"
"부산광역시 남구","2011","19","113583","298776","148108","150668","8.33","11144"
"부산광역시 남구","2012","19","113397","294673","145731","148942","8.25","10991"
"부산광역시 기장군","Oct-22","5","78528","180428","89604","90824","5.4","826"
"부산광역시 기장군","Nov-22","5","78629","180652","89717","90935","5.4","827"
"부산광역시 기장군","Dec-22","5","78736","180878","89880","90998","5.4","828"
"부산광역시 기장군","Jan-23","5","78917","181365","90096","91269","5.4","831"
"부산광역시 기장군","May-22","5","77472","178883","88867","90016","5.3","819"
"부산광역시 기장군","Jun-22","5","77954","179607","89238","90369","5.3","823"
"부산광역시 기장군","Jul-22","5","78044","179751","89281","90470","5.3","823"
"부산광역시 기장군","Aug-22","5","78169","179819","89311","90508","5.3","824"
"부산광역시 기장군","Sep-22","5","78402","180339","89556","90783","5.3","826"
"부산광역시 기장군","Jan-22","5","76901","178998","88883","90115","5.3","820"
"부산광역시 기장군","Feb-22","5","76959","178779","88781","89998","5.3","819"
"부산광역시 기장군","Mar-22","5","77015","178618","88723","89895","5.3","818"
"부산광역시 기장군","Apr-22","5","77093","178558","88691","89867","5.3","818"
"부산광역시 기장군","Sep-21","5","76434","178822","88790","90032","5.3","819"
"부산광역시 기장군","Oct-21","5","76577","178898","88810","90088","5.3","820"
"부산광역시 기장군","Nov-21","5","76725","179202","88960","90242","5.3","821"
"부산광역시 기장군","Dec-21","5","76853","179174","88992","90182","5.3","821"
"부산광역시 기장군","May-21","5","75858","178443","88672","89771","5.2","817"
"부산광역시 기장군","Jun-21","5","76058","178637","88783","89854","5.2","818"
"부산광역시 기장군","Jul-21","5","76241","178812","88852","89960","5.2","819"
"부산광역시 기장군","Aug-21","5","76369","178840","88837","90003","5.3","819"
"부산광역시 기장군","Jan-21","5","75182","177505","88202","89303","5.2","813"
"부산광역시 기장군","Feb-21","5","75533","178176","88533","89643","5.2","816"
"부산광역시 기장군","Mar-21","5","75496","178121","88509","89612","5.2","816"
"부산광역시 기장군","Apr-21","5","75708","178323","88616","89707","5.2","817"
"부산광역시 기장군","Aug-20","5","73320","174425","86717","87708","5.1","799"
"부산광역시 기장군","Sep-20","5","73657","174882","86962","87920","5.1","801"
"부산광역시 기장군","Oct-20","5","73915","175261","87136","88125","5.1","803"
"부산광역시 기장군","Nov-20","5","74280","176013","87529","88484","5.1","806"
"부산광역시 기장군","Dec-20","5","74649","176635","87811","88824","5.1","809"
"부산광역시 기장군","Feb-23","5","79089","181611","90253","91358","5.4","832"
"부산광역시 기장군","Mar-23","5","79179","181475","90243","91232","5.4","831"
"부산광역시 기장군","Apr-23","5","79487","181742","90360","91382","5.4","832"
"부산광역시 기장군","May-23","5","79623","181897","90429","91468","5.4","833"
"부산광역시 기장군","Mar-20","5","70686","169797","84487","85310","4.9","778"
"부산광역시 기장군","Apr-20","5","71059","170313","84740","85573","4.9","780"
"부산광역시 기장군","May-20","5","71661","171301","85207","86094","5","785"
"부산광역시 기장군","Jun-20","5","72166","172280","85639","86641","5","789"
"부산광역시 기장군","Jul-20","5","72804","173495","86236","87259","5","795"
"부산광역시 기장군","Sep-19","5","68892","167231","83267","83964","4.8","766"
"부산광역시 기장군","Oct-19","5","68963","167190","83231","83959","4.8","766"
"부산광역시 기장군","Nov-19","5","69103","167178","83220","83958","4.8","766"
"부산광역시 기장군","Dec-19","5","69136","166945","83076","83869","4.8","765"
"부산광역시 기장군","Jan-20","5","69244","166943","83126","83817","4.8","765"
"부산광역시 기장군","Feb-20","5","70005","168560","83878","84682","4.9","772"
"부산광역시 기장군","Apr-19","5","68513","167249","83201","84048","4.8","766"
"부산광역시 기장군","May-19","5","68569","167223","83188","84035","4.8","766"
"부산광역시 기장군","Jun-19","5","68649","167271","83224","84047","4.8","766"
"부산광역시 기장군","Jul-19","5","68739","167250","83218","84032","4.8","766"
"부산광역시 기장군","Aug-19","5","68809","167203","83241","83962","4.8","766"
"부산광역시 기장군","2018","5","67039","165784","82470","83314","4.7","759"
"부산광역시 기장군","2018","5","67275","166101","82594","83507","4.7","761"
"부산광역시 기장군","2018","5","67970","167162","83201","83961","4.8","766"
"부산광역시 기장군","Jan-19","5","68078","167222","83198","84024","4.8","766"
"부산광역시 기장군","Feb-19","5","68155","167132","83160","83972","4.8","766"
"부산광역시 기장군","Mar-19","5","68345","167269","83243","84026","4.8","766"
"부산광역시 기장군","2018","5","67707","166770","82953","83817","4.8","764"
"부산광역시 기장군","2018","5","67824","166985","83113","83872","4.8","765"
"부산광역시 기장군","2018","5","66030","164546","81940","82606","4.7","754"
"부산광역시 기장군","2018","5","66296","164684","81939","82745","4.7","754"
"부산광역시 기장군","2018","5","66431","164876","82041","82835","4.7","755"
"부산광역시 기장군","2017","5","65508","163632","81495","82137","4.6","750"
"부산광역시 기장군","2018","5","65918","164380","81874","82506","4.7","753"
"부산광역시 기장군","2018","5","66527","164935","82044","82891","4.7","756"
"부산광역시 기장군","2018","5","66765","165318","82211","83107","4.7","757"
"부산광역시 기장군","2018","5","67497","166463","82771","83692","4.8","763"
"부산광역시 기장군","2017","5","63515","161262","80262","81000","4.6","739"
"부산광역시 기장군","2017","5","63666","161318","80278","81040","4.6","739"
"부산광역시 기장군","2017","5","64941","162878","81113","81765","4.6","746"
"부산광역시 기장군","2017","5","65150","163099","81255","81844","4.6","747"
"부산광역시 기장군","2017","5","64565","162386","80856","81530","4.6","744"
"부산광역시 기장군","2017","5","65738","163920","81662","82258","4.7","751"
"부산광역시 기장군","2017","5","62908","160995","80087","80908","4.5","737"
"부산광역시 기장군","2017","5","63006","161102","80173","80929","4.5","738"
"부산광역시 기장군","2017","5","65738","163920","81662","82258","4.7","751"
"부산광역시 기장군","2017","5","63134","161105","80152","80953","4.5","738"
"부산광역시 기장군","2017","5","63226","161080","80159","80921","4.6","738"
"부산광역시 기장군","2012","5","45186","116064","58058","58006","3.25","532"
"부산광역시 기장군","2013","5","51840","134060","66760","67300","3.76","614"
"부산광역시 기장군","2014","5","56606","146615","72959","73656","4.12","672"
"부산광역시 기장군","2015","5","60024","155395","77379","78016","4.4","712"
"부산광역시 기장군","2016","5","62810","160888","80018","80870","4.5","737"
"부산광역시 기장군","2017","5","63951","161588","80426","81162","4.6","740"
"부산광역시 기장군","2007","5","30378","80438","40539","39899","2.23","369"
"부산광역시 기장군","2008","5","31769","82136","41388","40748","2.28","377"
"부산광역시 기장군","2009","5","35334","90380","45423","44957","2.53","414"
"부산광역시 기장군","2010","5","40664","103762","52082","51680","2.88","476"
"부산광역시 기장군","2011","5","42806","109495","54906","54589","3.05","502"
"부산광역시 금정구","Oct-22","16","107403","226775","110341","116434","6.7","3474"
"부산광역시 금정구","Nov-22","16","107061","226141","110009","116132","6.7","3464"
"부산광역시 금정구","Dec-22","16","106950","225717","109797","115920","6.7","3458"
"부산광역시 금정구","Jan-23","16","106606","224861","109361","115500","6.7","3445"
"부산광역시 금정구","Jun-22","16","107827","228255","111153","117102","6.7","3497"
"부산광역시 금정구","Jul-22","16","107729","227728","110901","116827","6.7","3488"
"부산광역시 금정구","Aug-22","16","107887","227436","110798","116638","6.7","3484"
"부산광역시 금정구","Sep-22","16","107535","227471","110637","116834","6.7","3485"
"부산광역시 금정구","Jan-22","16","107737","230711","112455","118256","6.8","3534"
"부산광역시 금정구","Feb-22","16","107785","229763","112011","117752","6.8","3520"
"부산광역시 금정구","Mar-22","16","107916","229693","111883","117810","6.8","3519"
"부산광역시 금정구","Apr-22","16","107856","229112","111612","117500","6.8","3510"
"부산광역시 금정구","May-22","16","107900","228835","111429","117406","6.8","3505"
"부산광역시 금정구","Sep-21","16","107990","233472","113699","119773","6.9","3578"
"부산광역시 금정구","Oct-21","16","108131","233233","113583","119650","6.9","3574"
"부산광역시 금정구","Nov-21","16","108257","232989","113466","119523","6.9","3570"
"부산광역시 금정구","Dec-21","16","108070","231996","113067","118929","6.8","3554"
"부산광역시 금정구","May-21","16","107158","233642","113868","119774","6.8","3580"
"부산광역시 금정구","Jun-21","16","107165","233081","113601","119480","6.8","3572"
"부산광역시 금정구","Jul-21","16","107360","232947","113558","119389","6.8","3570"
"부산광역시 금정구","Aug-21","16","107559","232836","113527","119309","6.8","3568"
"부산광역시 금정구","Jan-21","16","107415","235664","114741","120923","6.9","3611"
"부산광역시 금정구","Feb-21","16","107710","235357","114692","120665","6.9","3606"
"부산광역시 금정구","Mar-21","16","107184","234561","114304","120257","6.9","3594"
"부산광역시 금정구","Apr-21","16","107157","234173","114086","120087","6.9","3588"
"부산광역시 금정구","Aug-20","16","107323","238347","116173","122174","6.9","3652"
"부산광역시 금정구","Sep-20","16","107383","238173","115984","122189","6.9","3649"
"부산광역시 금정구","Oct-20","16","107345","237536","115637","121899","6.9","3639"
"부산광역시 금정구","Nov-20","16","107491","237153","115433","121720","6.9","3633"
"부산광역시 금정구","Dec-20","16","107561","236485","115133","121352","6.9","3624"
"부산광역시 금정구","Feb-23","16","106851","224410","109197","115213","6.7","3438"
"부산광역시 금정구","Mar-23","16","106954","224488","109119","115369","6.7","3439"
"부산광역시 금정구","Apr-23","16","106821","224011","108873","115138","6.7","3432"
"부산광역시 금정구","May-23","16","106809","223670","108693","114977","6.7","3426"
"부산광역시 금정구","Apr-20","16","107101","241100","117535","123565","7","3694"
"부산광역시 금정구","May-20","16","107313","240623","117312","123311","7","3687"
"부산광역시 금정구","Jun-20","16","107358","240006","117016","122990","7","3677"
"부산광역시 금정구","Jul-20","16","107273","238974","116481","122493","6.9","3661"
"부산광역시 금정구","Oct-19","17","106966","244786","119392","125394","7","3750"
"부산광역시 금정구","Nov-19","17","106984","244413","119219","125194","7","3744"
"부산광역시 금정구","Dec-19","17","107024","243870","119008","124862","7","3736"
"부산광역시 금정구","Jan-20","16","106857","243328","118742","124586","7","3728"
"부산광역시 금정구","Feb-20","16","107042","242911","118501","124410","7","3722"
"부산광역시 금정구","Mar-20","16","107184","242147","118010","124137","7","3710"
"부산광역시 금정구","Apr-19","17","106881","246812","120564","126248","7.1","3781"
"부산광역시 금정구","May-19","17","106994","246597","120403","126194","7.1","3778"
"부산광역시 금정구","Jun-19","17","107053","246226","120242","125984","7.1","3772"
"부산광역시 금정구","Jul-19","17","107025","245829","120043","125786","7.1","3766"
"부산광역시 금정구","Aug-19","17","107056","245408","119870","125538","7.1","3759"
"부산광역시 금정구","Sep-19","17","107073","245670","119807","125863","7.1","3763"
"부산광역시 금정구","2018","17","105979","247978","121515","126463","7.1","3799"
"부산광역시 금정구","2018","17","106203","248585","121715","126870","7.1","3809"
"부산광역시 금정구","Jan-19","17","106321","247167","120929","126238","7.1","3786"
"부산광역시 금정구","Feb-19","17","106628","247032","120806","126226","7.1","3784"
"부산광역시 금정구","Mar-19","17","106787","247105","120741","126364","7.1","3785"
"부산광역시 금정구","2018","17","106315","248191","121481","126710","7.1","3803"
"부산광역시 금정구","2018","17","106363","247983","121387","126596","7.1","3799"
"부산광역시 금정구","2018","17","106415","247725","121236","126489","7.1","3795"
"부산광역시 금정구","2018","17","105281","249054","122047","127007","7.1","3816"
"부산광역시 금정구","2018","17","105526","249289","122067","127222","7.1","3819"
"부산광역시 금정구","2018","17","105641","249034","121981","127053","7.1","3815"
"부산광역시 금정구","2018","17","105697","248256","121632","126624","7.1","3804"
"부산광역시 금정구","2017","17","104607","248822","121924","126898","7.1","3812"
"부산광역시 금정구","2017","17","104827","248917","121987","126930","7.1","3814"
"부산광역시 금정구","2018","17","104870","248807","121910","126897","7.1","3812"
"부산광역시 금정구","2018","17","105663","248836","121892","126944","7.1","3812"
"부산광역시 금정구","2018","17","105690","248606","121769","126837","7.1","3809"
"부산광역시 금정구","2017","17","103224","247970","121628","126342","7","3799"
"부산광역시 금정구","2017","17","103295","247647","121439","126208","7","3794"
"부산광역시 금정구","2017","17","103399","247317","121301","126016","7","3789"
"부산광역시 금정구","2017","17","103892","247777","121418","126359","7","3796"
"부산광역시 금정구","2017","17","104279","248334","121735","126599","7","3805"
"부산광역시 금정구","2017","17","103661","247118","121213","125905","7","3786"
"부산광역시 금정구","2017","17","102516","248517","121903","126614","7","3808"
"부산광역시 금정구","2017","17","102950","248576","121958","126618","7","3808"
"부산광역시 금정구","2017","17","103148","248680","121921","126759","7","3810"
"부산광역시 금정구","2017","17","103154","248359","121803","126556","7","3805"
"부산광역시 금정구","2012","17","99610","258066","127302","130764","7.22","3959"
"부산광역시 금정구","2013","17","100423","256015","126226","129789","7.18","3922"
"부산광역시 금정구","2014","17","100616","252850","124443","128407","7.11","3874"
"부산광역시 금정구","2015","17","101130","249778","122564","127214","7","3827"
"부산광역시 금정구","2016","17","102522","248908","122060","126848","7","3814"
"부산광역시 금정구","2017","17","104827","248917","121987","126930","7.1","3814"
"부산광역시 금정구","2007","18","92494","260844","129161","131683","7.22","4005"
"부산광역시 금정구","2008","18","93127","258604","127869","130735","7.19","3969"
"부산광역시 금정구","2009","17","93103","254272","125748","128524","7.11","3902"
"부산광역시 금정구","2010","17","96916","257662","127353","130309","7.16","3954"
"부산광역시 금정구","2011","17","98005","257090","126931","130159","7.17","3943"
"부산광역시 강서구","Oct-22","8","62601","148213","78210","70003","4.4","817"
"부산광역시 강서구","Nov-22","8","62497","148165","78259","69906","4.4","816"
"부산광역시 강서구","Dec-22","8","62426","148257","78413","69844","4.4","817"
"부산광역시 강서구","Jan-23","8","62358","148217","78438","69779","4.4","817"
"부산광역시 강서구","Jun-22","8","62674","148522","78244","70278","4.4","818"
"부산광역시 강서구","Jul-22","8","62758","148586","78263","70323","4.4","819"
"부산광역시 강서구","Aug-22","8","62728","148447","78219","70228","4.4","818"
"부산광역시 강서구","Sep-22","8","62645","148292","78217","70075","4.4","817"
"부산광역시 강서구","Jan-22","8","61711","147512","77712","69800","4.3","813"
"부산광역시 강서구","Feb-22","8","61929","147652","77762","69890","4.4","814"
"부산광역시 강서구","Mar-22","8","62135","147857","77818","70039","4.4","815"
"부산광역시 강서구","Apr-22","8","62285","148066","77948","70118","4.4","816"
"부산광역시 강서구","May-22","8","62530","148386","78147","70239","4.4","818"
"부산광역시 강서구","Sep-21","8","60878","146607","77292","69315","4.3","808"
"부산광역시 강서구","Oct-21","8","61157","146910","77451","69459","4.3","809"
"부산광역시 강서구","Nov-21","8","61397","147215","77590","69625","4.3","811"
"부산광역시 강서구","Dec-21","8","61502","147347","77658","69689","4.3","812"
"부산광역시 강서구","May-21","8","59598","144752","76249","68503","4.2","798"
"부산광역시 강서구","Jun-21","8","59954","145270","76539","68731","4.3","800"
"부산광역시 강서구","Jul-21","8","60289","145740","76786","68954","4.3","803"
"부산광역시 강서구","Aug-21","8","60574","146189","77049","69140","4.3","805"
"부산광역시 강서구","Jan-21","8","58512","143347","75515","67832","4.2","790"
"부산광역시 강서구","Feb-21","8","58905","143787","75736","68051","4.2","792"
"부산광역시 강서구","Mar-21","8","58879","143899","75819","68080","4.2","793"
"부산광역시 강서구","Apr-21","8","59236","144243","75992","68251","4.2","795"
"부산광역시 강서구","Aug-20","8","55958","138423","73091","65332","4","763"
"부산광역시 강서구","Sep-20","8","56828","140337","74069","66268","4.1","773"
"부산광역시 강서구","Oct-20","8","57341","141418","74572","66846","4.1","779"
"부산광역시 강서구","Nov-20","8","57690","142064","74866","67198","4.1","783"
"부산광역시 강서구","Dec-20","8","58141","142719","75157","67562","4.2","786"
"부산광역시 강서구","Feb-23","8","62350","148060","78393","69667","4.4","816"
"부산광역시 강서구","Mar-23","8","62376","148176","78446","69730","4.4","816"
"부산광역시 강서구","Apr-23","8","62443","148315","78561","69754","4.4","817"
"부산광역시 강서구","May-23","8","62466","148504","78739","69765","4.4","818"
"부산광역시 강서구","Apr-20","8","54725","136516","72206","64310","3.9","752"
"부산광역시 강서구","May-20","8","54994","136814","72352","64462","4","754"
"부산광역시 강서구","Jun-20","8","55158","137005","72436","64569","4","755"
"부산광역시 강서구","Jul-20","8","55314","137122","72447","64675","3.9","756"
"부산광역시 강서구","Oct-19","8","52995","133825","70899","62926","3.9","737"
"부산광역시 강서구","Nov-19","8","53242","134211","71107","63104","3.9","739"
"부산광역시 강서구","Dec-19","8","53731","135048","71570","63478","3.9","744"
"부산광역시 강서구","Jan-20","8","54087","135812","71980","63832","3.9","748"
"부산광역시 강서구","Feb-20","8","54359","136226","72139","64087","3.9","751"
"부산광역시 강서구","Mar-20","8","54611","136491","72232","64259","3.9","752"
"부산광역시 강서구","Apr-19","8","52038","131816","69863","61953","3.8","726"
"부산광역시 강서구","May-19","8","52192","132181","70018","62163","3.8","728"
"부산광역시 강서구","Jun-19","8","52324","132428","70139","62289","3.8","730"
"부산광역시 강서구","Jul-19","8","52396","132531","70210","62321","3.8","730"
"부산광역시 강서구","Aug-19","8","52515","132825","70368","62457","3.8","732"
"부산광역시 강서구","Sep-19","8","52734","133231","70551","62680","3.8","734"
"부산광역시 강서구","2018","8","49292","126002","66894","59108","3.6","694"
"부산광역시 강서구","2018","8","49474","126412","67132","59280","3.6","697"
"부산광역시 강서구","Jan-19","8","50973","129547","68763","60784","3.7","714"
"부산광역시 강서구","Feb-19","8","51556","130928","69450","61478","3.8","721"
"부산광역시 강서구","Mar-19","8","51817","131403","69675","61728","3.8","724"
"부산광역시 강서구","2018","8","49667","126769","67296","59473","3.6","698"
"부산광역시 강서구","2018","8","49936","127344","67618","59726","3.6","702"
"부산광역시 강서구","2018","8","50488","128611","68255","60356","3.7","709"
"부산광역시 강서구","2018","8","48183","123636","65771","57865","3.5","681"
"부산광역시 강서구","2018","8","48407","124002","65949","58053","3.5","683"
"부산광역시 강서구","2018","8","48547","124276","66086","58190","3.5","685"
"부산광역시 강서구","2018","8","48952","125230","66512","58718","3.6","690"
"부산광역시 강서구","2017","7","47787","123023","65476","57547","3.5","678"
"부산광역시 강서구","2017","7","47850","123079","65532","57547","3.5","678"
"부산광역시 강서구","2018","8","47892","123120","65516","57604","3.5","678"
"부산광역시 강서구","2018","8","48673","124496","66170","58326","3.5","686"
"부산광역시 강서구","2018","8","48718","124629","66222","58407","3.6","687"
"부산광역시 강서구","2017","7","46436","120104","63911","56193","3.4","662"
"부산광역시 강서구","2017","7","46757","120928","64368","56560","3.4","666"
"부산광역시 강서구","2017","7","47040","121634","64718","56916","3.4","670"
"부산광역시 강서구","2017","7","47712","123027","65405","57622","3.5","678"
"부산광역시 강서구","2017","7","47728","122948","65409","57539","3.5","677"
"부산광역시 강서구","2017","7","47489","122632","65247","57385","3.5","676"
"부산광역시 강서구","2017","7","44496","115553","61680","53873","3.3","637"
"부산광역시 강서구","2017","7","45141","117161","62436","54725","3.3","646"
"부산광역시 강서구","2017","7","45559","118050","62835","55215","3.3","650"
"부산광역시 강서구","2017","7","45942","118978","63309","55669","3.4","656"
"부산광역시 강서구","2012","7","27838","70356","38397","31959","1.97","387"
"부산광역시 강서구","2013","7","29491","74765","40752","34013","2.1","412"
"부산광역시 강서구","2014","7","33165","85097","46282","38815","2.39","469"
"부산광역시 강서구","2015","7","38727","100597","54275","46322","2.8","554"
"부산광역시 강서구","2016","7","44112","114749","61364","53385","3.2","632"
"부산광역시 강서구","2017","7","47850","123079","65532","57547","3.5","678"
"부산광역시 강서구","2007","7","21605","55046","30098","24948","1.52","305"
"부산광역시 강서구","2008","7","22132","55858","30815","25043","1.55","312"
"부산광역시 강서구","2009","7","25009","63753","34527","29226","1.78","356"
"부산광역시 강서구","2010","7","26296","66269","35996","30273","1.84","368"
"부산광역시 강서구","2011","7","27325","69371","37853","31518","1.93","384"
"부산광역시","Oct-22","205","1556293","3370450","1648595","1721855","100","4376"
"부산광역시","Nov-22","205","1555836","3369246","1647951","1721295","100","4375"
"부산광역시","Dec-22","205","1555867","3367246","1646807","1720439","100","4372"
"부산광역시","Jan-23","205","1556086","3365553","1645779","1719774","100","4370"
"부산광역시","Feb-23","205","1559593","3364647","1645116","1719531","100","4369"
"부산광역시","Jun-22","205","1556938","3383254","1655876","1727378","100","4393"
"부산광역시","Jul-22","205","1558052","3381143","1654647","1726496","100","4390"
"부산광역시","Aug-22","205","1559462","3378032","1652900","1725132","100","4386"
"부산광역시","Sep-22","205","1555449","3371679","1649372","1722307","100","4378"
"부산광역시","Feb-22","205","1549967","3392611","1661587","1731024","100","4405"
"부산광역시","Mar-22","205","1551767","3389422","1659549","1729873","100","4401"
"부산광역시","Apr-22","205","1553032","3386349","1657865","1728484","100","4397"
"부산광역시","May-22","205","1555326","3384454","1656625","1727829","100","4394"
"부산광역시","Oct-21","205","1541975","3402414","1667077","1735337","100","4418"
"부산광역시","Nov-21","205","1543438","3399654","1665542","1734112","100","4415"
"부산광역시","Dec-21","205","1544663","3396109","1663619","1732490","100","4410"
"부산광역시","Jan-22","205","1546414","3394450","1662769","1731681","100","4407"
"부산광역시","Jun-21","205","1533514","3410352","1672132","1738220","100","4429"
"부산광역시","Jul-21","205","1535294","3407350","1670484","1736866","100","4425"
"부산광역시","Aug-21","205","1537395","3404709","1668899","1735810","100","4421"
"부산광역시","Sep-21","205","1540342","3404876","1668426","1736450","100","4422"
"부산광역시","Jan-21","205","1532700","3435787","1684737","1751050","100","4462"
"부산광역시","Feb-21","205","1536242","3433724","1683548","1750176","100","4459"
"부산광역시","Mar-21","205","1527830","3418924","1676908","1742016","100","4440"
"부산광역시","Apr-21","205","1529794","3416090","1675239","1740851","100","4436"
"부산광역시","May-21","205","1532053","3413415","1673765","1739650","100","4433"
"부산광역시","Sep-20","205","1523122","3447612","1691631","1755981","100","4477"
"부산광역시","Oct-20","205","1524888","3445191","1690176","1755015","100","4474"
"부산광역시","Nov-20","205","1527721","3442633","1688633","1754000","100","4471"
"부산광역시","Dec-20","205","1530431","3438710","1686412","1752298","100","4465"
"부산광역시","Mar-23","205","1561008","3364066","1644310","1719756","100","4368"
"부산광역시","Apr-23","205","1561666","3362430","1643246","1719184","100","4366"
"부산광역시","May-23","205","1562595","3361053","1642389","1718664","100","4364"
"부산광역시","Mar-20","205","1505897","3461724","1700307","1761417","100","4495"
"부산광역시","Apr-20","205","1507504","3458506","1698525","1759981","100","4491"
"부산광역시","May-20","205","1511199","3455718","1696813","1758905","100","4488"
"부산광역시","Jun-20","205","1513956","3452910","1695099","1757811","100","4484"
"부산광역시","Jul-20","205","1517200","3450783","1693918","1756865","100","4484"
"부산광역시","Aug-20","205","1520321","3448570","1692507","1756063","100","4478"
"부산광역시","Oct-19","206","1495123","3472359","1707262","1765097","100","4510"
"부산광역시","Nov-19","206","1496361","3470256","1706084","1764172","100","4507"
"부산광역시","Dec-19","206","1497908","3466563","1704098","1762465","100","4502"
"부산광역시","Jan-20","205","1499152","3464508","1702899","1761609","100","4499"
"부산광역시","Feb-20","205","1502333","3463429","1701907","1761522","100","4498"
"부산광역시","May-19","206","1489073","3481742","1713072","1768670","100","4522"
"부산광역시","Jun-19","206","1490226","3479684","1711770","1767914","100","4519"
"부산광역시","Jul-19","206","1491205","3477256","1710383","1766873","100","4516"
"부산광역시","Aug-19","206","1492645","3475051","1709212","1765839","100","4513"
"부산광역시","Sep-19","206","1494074","3475319","1708756","1766563","100","4514"
"부산광역시","2018","206","1475668","3501436","1725901","1775535","100","4547"
"부산광역시","2018","206","1477190","3502021","1725861","1776160","100","4548"
"부산광역시","Jan-19","206","1481315","3490727","1719434","1771293","100","4534"
"부산광역시","Feb-19","206","1483699","3488127","1717892","1770235","100","4530"
"부산광역시","Mar-19","206","1485852","3487142","1716545","1770597","100","4529"
"부산광역시","Apr-19","206","1487469","3484179","1714664","1769515","100","4525"
"부산광역시","2018","206","1479534","3496997","1723147","1773850","100","4541"
"부산광역시","2018","206","1480468","3494019","1721327","1772692","100","4538"
"부산광역시","2018","206","1471933","3513693","1732694","1780999","100","4563"
"부산광역시","2018","206","1472729","3511157","1731259","1779898","100","4560"
"부산광역시","2018","206","1473233","3508576","1729823","1778753","100","4556"
"부산광역시","2017","205","1467555","3520306","1736878","1783428","100","4572"
"부산광역시","2018","206","1468069","3516594","1734978","1781616","100","4567"
"부산광역시","2018","206","1470058","3514419","1733725","1780694","100","4564"
"부산광역시","2018","206","1473448","3506103","1728471","1777632","100","4553"
"부산광역시","2018","206","1474088","3503772","1727156","1776616","100","4550"
"부산광역시","2018","206","1478697","3499004","1724190","1774814","100","4544"
"부산광역시","2017","205","1460244","3534848","1744966","1789882","100","4591"
"부산광역시","2017","205","1462269","3533065","1744087","1788978","100","4589"
"부산광역시","2017","205","1466181","3532896","1743075","1789821","100","4589"
"부산광역시","2017","205","1466384","3527572","1740579","1786993","100","4582"
"부산광역시","2017","205","1466889","3524210","1738793","1785417","100","4578"
"부산광역시","2017","205","1452162","3544675","1751037","1793638","100","4604"
"부산광역시","2017","205","1454891","3542946","1749907","1793039","100","4602"
"부산광역시","2017","205","1456356","3541509","1748351","1793158","100","4600"
"부산광역시","2017","205","1457360","3539532","1747332","1792200","100","4597"
"부산광역시","2017","205","1459062","3537513","1746325","1791188","100","4595"
"부산광역시","2012","214","1389526","3573533","1774993","1798540","100","4643"
"부산광역시","2013","210","1404663","3563578","1767963","1795615","100","4629"
"부산광역시","2014","210","1421648","3557716","1762869","1794847","100","4621"
"부산광역시","2015","206","1437818","3559780","1761594","1798186","100","4624"
"부산광역시","2016","205","1451270","3546887","1752465","1794422","100","4607"
"부산광역시","2017","205","1467555","3520306","1736878","1783428","100","4572"
"부산광역시","2017","205","1464626","3532088","1743282","1788806","100","4588"
"부산광역시","2007","223","1300692","3615101","1801832","1813269","100","4722"
"부산광역시","2008","217","1311724","3596063","1791273","1804790","100","4695"
"부산광역시","2009","215","1323771","3574340","1778834","1795506","100","4666"
"부산광역시","2010","215","1371346","3600381","1791455","1808926","100","4692"
"부산광역시","2011","214","1381257","3586079","1783378","1802701","100","4667"
